
0,0,0,0,0,0,0,0,0,0,0,0,0,0,0,0,0,0,0,0,0,0,0,0,0,0,0,0,0,0,0,0,0,0,0,0,0,0,0,0,0,0
0,1,0,1,1,0,0,1,1,1,0,0,0,1,1,0,1,1,1,0,1,0,1,1,1,1,0,1,1,0,1,0,0,0,1,0,1,1,1,1,0,1,1,0,0,0,1,1,1,0,1,1,0,0,1,1,1
1,1,1,0,0,1,1,1,1,1,0,0,0,1,1,0,1,0,1,0,1,0,1,1,1,1,0,1,1,1,0,0,0,1,1,1,0,0,0,0,1,1,1,1,1,1,1,1,1,1,0,0,1,1,0,1,0,1,0,1,0,0,1,1,1,1,1,0,0,0
0,0,1,1,0,2,0,0,1,1,2,0,0,2,0,1,0,1,2,1,2,1,0,1,2,1,2,1,1,1,1,0,0,0,1,2,1,2,2,2,0,1,1,1,2,1,2,1,2,1,2,0,1,2,0,1,2,0,1,1,1,1,1,1,0,0,2,2,2,0,1,0,1,1,1,2,2,2,1,0,1,2,0,1,2,0,1,2,2,2,2,2,0
16,2,0,1,2,2,0,1,1,1,2,1,2,0,0,1,2,1,1,0,0,1,0,1,0,2,0,1,1,1,2,0,1,2,0,2,2,2,2,16,0,0,2,2,2,1,2,2,1,2,0,2,1,2,0,1,2,2,1,2,1,0,0,1,0,2,2,2,0,2,1,0,1,2,2,2,1,2,0,2,0,1,16,2,1,0,0,1,2,1,2,2,2,1,2,0,1,2,0,1,2,2,1,0,2,1,2
3,3,3,2,2,1,3,2,1,2,3,0,0,0,1,2,3,2,1,3,3,2,1,3,3,3,2,2,1,2,3,0,3,0,0,0,0,0,3,2,3,1,3,0,2,1,3,0,2,2,2,3,3,3,2,3,1,3,0,0,2,3,2,1,3,2,1,0,2,1,3,0,2,1,3,0,2,3,2,3,1,0,3,1,1,1,2,1,2,1,2,0,3,3,3,0,2,3,0,1,2,1,2,3,3,3,2,3,2,3,2,1,2,3,0
0,1,2,3,4,0,4,0,1,0,2,4,0,2,4,3,0,4,1,2,4,2,3,1,2,4,4,4,4,4,1,2,1,3,1,2,0,4,0,4,4,4,0,1,4,2,4,0,4,4,4
4,3,0,1,4,2,4,2,4,1,4,4,2,4,0,1,4,0,3,4,0,4,3,4,1,2,4,3,4,3,0,1,3,2,4,3,4,3,2,0,3,4,0,1,0,2,0,3,0,1,1,1,2,4,1,4,2,1,3,1,4,2,1,3,1,0,0,4,4,0,1,4,2,1,2,2,4,2,3,4,2,1,4,2,1,4,4,4,4,4,4,4,4,0,2,4,4,1,0,1,2,0,3,0,4,2,3,0,3,0,3,2,0,1,3,4,4,0,1,3,0,4,2,3,0,1,2,3,4,4,0,1,4,0,3,2,4,1,0,4,4,4,2,3,0,1,3,3,3,4,4,4,4,4,4,3,3,2,1,2,1,3,2,3,3,3,2,3,4,4,2,1,0,4,1,0,1,4,0,1,0,4,2,0,3,3,2,4,0
5,0,1,2,3,4,0,5,5,4,0,1,0,2,4,0,2,4,3,5,5,0,5,4,1,5,2,4,2,3,1,5,2,4,5,5,5,5,4,5,4,4,1,2,1,0,1,2,0,4,3,4,5,2,0,1,5,2,4,0,4,5,5
17,3,0,2,0,4,5,4,5,2,1,0,5,0,2,1,2,0,4,1,5,4,3,2,5,17,1,5,0,4,0,5,2,1,4,3,3,1,0,4,3,5,5,1,0,17,3,2,3,1,0,0,5,0,1,0,4,1,1,1,5,2,4,1,17,2,4,1,2,5,2,5,5,4,3,2,1,0,5,4,1,5,2,5,3,17,2,0,1,5,2,0,1,4,2,0,1,3,2,17,1,2,4,2,0,5,5,5,3,4,3,4,3,5,3,2,1,2,5,4,1,5,5,2,5,1,4,3,0,1,5,4,2,3,0,1,5,5,4,2,5,17,3,2,1,4,5,2,1,4,5,4,5,4,5,2,0,1,0,5,5,5,5,4,1,2,5,1,2,4,0,1,2,3,1,4,5,2,1,0,5,0,4,17,1,2,0,5,1,3,0,5,0,0,5,0,17,1,4,1,5
6,0,1,0,6,6,5,6,5,0,4,6,3,2,1,0,1,2,1,3,1,4,6,1,5,1,6,1,2,3,6,0,6,4,5,3,2,1,0,6,0,4,3,2,1,2,3,4,3,2,1,6,6,6,0
0,0,0,0,0,6,6,5,6,5,6,5,6,4,0,6,5,6,6,0,0,0,0,0,0,0,0,6,3,6,2,6,1,0,0,0,0,0,6,0,0,0,6,1,6,1,5,1,4,1,2,1,3,0,0,0,0,0,6,1,6,1,5,1,6,0,0,0,0,0,0,0,0,0,0,0,0,4,5,4,6,4,3,4,5,4,4,4,6,5,6,5,6,0,0,0,0,0,0,5,6,1,6,1,5,0,5,0,4,0,6,6,6,6,0,0,0,0,0,0,0,6,5,0,5,4,0,4,3,0,3,2,0,0,0,6,0,0,0,2,1,0,1,6,6,6,6,6,6,0,0,0,0,0,0,5,5,5,5,5,0,0,0,0,0,0,4,4,4,4,0,0,0,0,0,0,0,0,0,0,0,0,3,3,3,2,2,1,0,0,0,6,6,0,4,0,0,0,0,0,0,5,4,6,0,5,6,2,0,6,4,3,0,5,6,5,6,5,4,5,6,3,2,5,6,2,1,5,6,3,2,4,0,0,0,0,0,6,5,2,1,5,6,6,5,6,5,6,3,5,3,6,2,4,1,5,2,1,4,2,0,0,0,0,0,0,0,1,5,0,1,6,6
6,5,6,5,6,0,0,0,0,0,0,4,6,5,6,4,0,0,0,0,0,0,6,4,6,6,0,0,0,0,0,0,3,6,3,5,3,4,0,0,0,0,0,0,3,6,3,5,3,6,3,5,3,4,3,2,3,2,3,2,3,0,0,0,0,0,0,6,3,6,3,0,1,0,6,0,5,0,4,0,0,0,0,5,0,6,0,4,0,3,0,5,0,6,0,1,0,0,0,0,2,0,5,0,4,3,0,6,0,6,5,0,2,0,3,0,5,0,0,0,0,0,0,0,1,0,6,0,5,0,4,0,3,0,6,0,0,0,0,0,0,0,5,0,6,0,4,0,5,0,3,0,6,0,5,0,4,0,5,6,6,6,6,0,0,0,0,0,0,6,6,6,6,5,4,5,5,6,0,0,0,0,0,0,5,6,3,2,5,3,4,0,1,5,0,1,5,0,0,0,0,0,0,0,6,0,4,6,3,5,2,1,4,6,5,3,0,4,6,5,3,0,2,1,5,6,2,0,1,6,6,5,4,5,6,3,2,5,6,3,2,5,4,1,2,5,6,3,0,1,4,5,2,0,1,5,6,3,0,2,4,1,0,5,6,3,2,0,1,4,5,0,1,5,2,0,1,4,6
0,7,1,2,7,6,0,6,0,3,0,0,0,0,0,0,5,7,6,5,6,7,5,6,4,0,6,5,6,3,0,0,0,0,0,0,1,2,1,3,2,1,6,0,7,7,0,0,0,0,0,0,0,6,3,6,2,6,1,0,7,0,0,0,0,0,0,0,0,7,0,0,0,0,0,0,0,0,7,1,1,2,1,5,4,6,0,0,7,0,6,1,2,1,2,3,5,4,6,0,0,0,0,0,0,7,7,6,1,5,1,4,7,1,2,0,7,6,5,4,3,2,1,0,0,0,0,0,0,3,1,6,0,0,0,0,0,0,1,5,7,1,6,4,5,0,0,0,0,0,0,7,4,6,0,7,1,0,0,0,0,0,0,7,4,3,4,5,4,7,7,0,4,4,6,5,0,0,0,0,0,0,6,5,0,3,5,7,5,6,0,0,0,0,0,0,1,6,7,5,0,5,0,0,0,0,0,0,0,4,0,6,7,6,6,0,6,5,0,0,0,0,0,0,0,5,4,0,4,3,0,3,2,0,2,1,0,0,0,0,0,0,0,1,7,7,7,7,7,7,7,0,0,0,0,0,0,7,6,6,6,6,6,6,0,0,0,0,0,0,7,5,5,5,5,5,0,0,0,0,0,0,7,4,4,4,4,7,0,0,0,0,0,0,3,3,3,7,2,2,7,1,0,0,0,6,7,0,4,7,5,4,6,0,0,0,0,0,0,0,5,6,2,0,7,6,4,3,0,5,6,5,6,5,4,0,0,0,
7,7,8,6,8,6,8,5,5,8,6,8,7,4,8,8,16,4,3,8,2,5,7,6,3,2,2,8,8,1,1,7,6,8,7,8,16,7,1,8,2,7,2,3,7,3,8,4,7,4,5,7,17,5,8,8,8,6,7,6,8,7,8,7,8,8,7,1,8,17,8,1,8,1,8,2,7,2,7,1,2,7,8,8,8
8,8,6,8,8,7,1,7,8,8,6,6,8,5,5,8,4,8,8,6,8,3,8,4,8,8,5,8,7,6,8,4,7,4,3,8,5,8,4,8,7,6,2,8,1,8,7,4,8,6,5,3,8,8,7,5,8,6,5,4,8,2,8,5,6,3,2,4,8,2,8,1,2,5,4,8,7,8,2,1,1,8,8,7,1,4,5,1,2,4,8,8,5,3,2,1,5,7,4,8,4,5,1,8,4,2,3,8,4,8,4,2,8,7,8,2,1,5,8,4,2,3,8,6,8,4,8,7,5,8,7,5,2,1,8,5,2,8,8,8,8,8,8,8,8,8,8,6,8,4,2,5,8,4,8,3,2,4,8,1,8,1,8,1,8,1,8,6,2,4,7,5,1,7,8,8,4,5,2,1,2,4,5,8,7,5,8,7,4,1,8,2,3,8,8,6,5,8,7,8,5,7,8,1,2,8,4,1,8,5,8,6,3,2,5,8,4,1,2,5,4,2,7,8,2,4,8,7,6,5,8,8,2,3,8,4,1,8,2,1,8,8,4,5,8,1,3,4,5,8,6,5,7,2,8,4,5,8,4,8,8,6,8,4,2,8,1,8,2,1,8,3,8,2,8,1,8,8,4,2,4,1,3,5,4,8,4,7,5,7,8,5,1,8,7,5,4,8,5,8,3,2,1,4,1,2,3,7,3,4,7,8,8,8,8,1,8,1,1,8,2,7,8,2,7,1,8,2,7
9,7,9,7,8,9,6,8,6,8,9,5,9,5,8,9,4,6,8,7,9,9,4,8,4,8,1,4,9,9,3,8,2,5,7,6,3,9,9,2,2,8,8,1,1,7,6,8,9,9,7,9,8,1,7,1,9,8,2,7,2,9,3,7,9,3,8,4,7,4,9,5,7,5,8,8,9,9,9,8,6,7,6,8,7,9,9,8,7,8,8,7,9,9,1,8,9,1,8,9,1,9,8,1,8,9,2,7,2,7,1,2,7,8,9,8,8,9,9,9
9,7,9,4,7,8,9,6,8,6,8,9,5,9,5,8,9,6,8,7,9,9,4,8,8,1,4,9,9,3,8,2,5,7,6,3,9,4,9,2,2,8,8,1,1,7,6,8,9,9,7,9,8,1,7,1,9,8,2,7,2,9,3,7,9,3,8,4,7,9,7,9,7,8,9,6,8,6,8,9,5,9,5,8,9,6,8,7,9,9,4,8,8,1,4,9,9,3,8,2,5,7,6,3,9,9,2,2,8,1,8,1,1,7,6,8,9,9,7,9,8,1,7,1,9,8,2,7,2,9,3,7,9,3,8,4,7,4,9,5,7,5,8,8,9,9,9,8,6,7,6,8,7,9,9,8,7,8,8,7,9,9,1,8,9,1,8,9,1,9,8,1,8,9,2,7,2,7,1,2,7,8,9,8,8,9,9,9,4,9,5,7,5,8,8,7,8,9,9,9,8,6,7,6,8,7,9,9,8,7,8,8,7,9,9,1,8,9,1,8,9,1,9,8,1,8,9,2,7,2,7,1,2,7,8,9,8,8,9,9,9
7,9,7,9,8,9,7,9,7,8,9,6,8,6,8,9,5,9,5,8,9,6,8,7,9,9,4,8,8,1,4,9,9,3,8,2,5,4,7,6,3,9,9,2,2,8,8,1,1,7,6,8,9,9,7,9,8,1,7,1,9,8,2,7,2,1,9,3,7,9,3,8,4,7,4,9,5,7,5,8,8,9,9,9,8,6,7,6,8,7,9,9,8,7,8,8,7,9,9,1,8,9,1,4,8,9,1,9,8,1,8,9,2,7,2,7,2,7,8,9,8,8,9,9,9,6,8,6,8,9,5,5,8,6,8,7,9,9,4,8,8,1,4,9,9,3,8,2,5,9,7,6,3,9,9,2,2,8,8,1,1,7,6,8,9,9,7,8,9,1,7,9,1,9,8,2,7,2,9,3,7,3,8,4,7,4,9,5,7,5,8,8,8,6,7,6,8,7,9,9,8,7,8,9,8,7,9,9,1,9,9,8,9,1,9,9,9,9,8,9,1,8,9,1,8,2,7,9,2,7,1,2,7,8,9,8,9,8,9,2,1,5,9,2,1,2,9,4,1,5,9,9,9,5,6,4,9,3,9,5,6,9,1,9,9,9,9
10,9,7,4,6,18,3,9,7,1,1,1,8,9,6,1,8,6,18,10,9,5,16,9,1,5,8,9,6,8,7,9,1,9,4,8,8,1,17,4,1,1,9,9,3,1,1,8,2,5,7,18,1,6,3,9,16,1,9,1,2,2,8,1,10,18,1,7,6,1,8,9,9,7,1,17,9,8,1,7,10,17,1,9,8,1,2,7,2,9,1,3,7,9,3,8,18,4,7,9,7,9,1,7,10,9,1,6,8,18,6,8,1,9,5,1,9,5,8,1,9,6,8,7,9,1,9,17,1,1,18
10,1,1,9,7,9,10,7,1,1,10,8,9,6,1,9,7,9,7,1,1,1,8,9,6,1,8,10,6,10,8,9,5,1,9,1,5,8,9,6,8,7,9,1,9,4,8,8,1,10,4,1,10,9,9,3,10,10,8,10,2,5,7,1,10,6,3,9,1,1,9,10,2,2,8,1,8,1,1,7,6,10,8,9,9,10,10,6,3,9,1,10,9,10,2,2,8,10,8,1,1,7,6,10,8,9,9,7,1,1,9,8,10,7,1,1,9,8,10,2,7,2,10,9,1,3,7,9,3,8,10,4,7,9,7,9,1,7,8,9,1,6,8,10,6,8,10,9,5,10,9,5,8,10,9,6,8,7,9,1,10,9,10,10,1,7,1,10,9,8,1,7,10,10,9,8,10,2,7,2,9,1,3,7,9,3,8,10,4,7,9,7,9,10,7,8,9,1,6,8,10,1,6,8,1,9,5,1,9,5,8,10,9,6,8,7,9,10,9,10,1,10,1,8,6,1,8,9,5,10,9,1,5,8,10,9,6,8,7,9,1,9,4,8,8,10,1,4,1,1,9,9,3,10,10,1,8,2,5,7,10,1,6,3,9,1,10,9,10,2,2,8,10,8,10,10,7,6,1,8,9,9,7,10,10,10,9,8,1,7,10,1,9,8,1,2,7,2,9,10,3,7,9,3,8,1,4,7,9,7,9,1,7,8,9,10,6,8,1,6,8,1,9,5,10,7,9,5,8,10,9,6,8,7,9,10,9,10,1,10
11,1,4,11,1,9,7,4,11,5,11,7,11,2,9,7,1,11,1,2,11,6,5,6,6,6,3,6,2,6,1,2,3,11,4,5,1,1,8,9,6,1,8,11,1,11,1,6,1,8,9,5,1,9,1,11,11,4,3,4,1,2,4,3,3,11,1,2,7,1,3,4,11,5,8,9,6,8,7,9,1,9,11,1,11,4,11,5,11,6,11,11,11,11,11,4,8,8,1,1,4,5,11,6,11,1,1,9,9,3,1,1,1,2,3,4,2,7,6,5,4,3,2,1,5,6,7,8,9,1,11,1,8,2,5,7,1,1,6,3,9,1,1,9,1,2,1,2,3,11,2,8,1,8,1,1,7,6,11,11,11,1,11,1,8,9,5,6,3,2,11,11,11,4,5,11,2,1,5,6,9,7,1,4,9,11,11,4,9,11,1,9,8,1,7,1,1,9,8,1,11,8,6,3,11,2,5,8,11,4,2,7,2,11,11,11,11,11,9,1,3,7,9,3,8,1,4,7,9,7,9,11,4,11,5,11,2,11,2,11,2,1,7,8,9,1,6,8,1,1,11,2,11,3,6,8,1,9,5,1,9,5,8,1,9,6,11,8,7,9,1,9,11,11,1,1,1,11,2,7,1,2,11,7,8,9,11,8,11,8,11,9,9,9,11,4,9,5,7,5,11,11,11,2,11,2,11,1,11,11,11,3,11,4
11,1,4,11,1,9,7,11,10,8,6,11,6,8,11,4,11,5,11,7,11,2,9,7,10,1,11,2,4,3,5,5,1,2,11,2,3,11,4,5,1,1,8,9,6,1,10,11,8,1,1,7,6,8,9,11,1,11,1,6,1,8,9,5,1,9,1,11,10,2,1,4,11,3,11,1,4,2,3,1,2,11,7,1,3,4,11,5,8,9,6,8,7,9,1,9,11,10,11,4,11,5,11,6,11,11,11,11,11,4,8,8,1,1,4,5,11,6,11,1,10,9,9,3,1,1,1,2,3,4,5,6,7,8,9,1,11,1,8,2,5,7,1,1,6,3,9,1,1,9,1,2,10,2,3,11,2,8,1,8,1,1,7,6,11,11,11,1,11,1,8,9,9,7,10,4,9,11,11,4,9,11,1,9,8,1,7,1,1,9,8,1,2,7,10,2,11,11,11,11,11,9,1,3,7,9,3,8,1,4,7,9,7,9,10,4,11,5,11,2,11,2,11,2,1,7,8,9,1,6,8,1,1,11,2,11,3,6,8,1,9,5,1,9,5,8,1,9,10,11,8,7,9,1,9,11,11,1,1,1,11,11,11,11,9,1,3,7,9,3,8,1,4,7,9,7,9,11,4,11,5,11,2,10,2,11,2,1,7,8,9,1,6,8,1,5,11,2,11,6,3,5,8,7,5,4,8,7,5,2,1,6,8,7,11,1
12,1,4,11,12,1,9,7,4,11,12,5,11,12,7,11,12,2,9,7,1,11,1,12,2,11,2,3,12,11,4,12,5,1,12,1,8,9,6,1,12,8,11,1,11,1,12,6,1,8,9,5,1,12,9,1,11,12,11,1,2,12,7,1,3,4,11,5,8,9,6,12,8,7,9,12,12,12,1,9,11,1,11,4,11,5,11,12,11,11,1,11,12,4,8,8,12,1,4,5,11,6,11,1,1,9,9,3,1,12,12,12,1,1,2,3,4,5,6,7,8,9,1,11,4,12,1,8,2,5,7,1,1,6,3,9,12,1,1,9,1,2,1,12,3,11,2,8,1,8,1,12,1,7,6,11,12,11,11,12,12,12,11,1,12,9,12,9,7,1,4,9,11,11,4,9,12,12,12,11,1,9,8,1,7,1,1,9,8,1,2,7,12,11,11,11,11,11,9,1,3,12,7,9,3,8,1,4,12,7,9,7,9,12,11,4,11,12,12,12,5,11,2,11,2,11,2,1,7,12,8,9,1,6,8,12,1,1,11,2,11,3,12,6,8,1,9,5,12,1,9,5,8,12,12,1,9,6,11,12,8,7,9,1,9,11,12,1,12,1,12,9,6,3
13,9,7,9,17,7,8,9,6,8,17,12,13,11,7,13,6,8,9,19,9,13,17,1,17,12,13,13,13,5,8,9,6,8,7,9,17,9,13,18,8,8,17,11,7,12,13,4,9,9,6,6,19,5,18,4,3,3,1,17,12,8,2,5,12,11,7,7,6,3,9,13,13,13,13,13,9,2,2,8,8,1,7,17,7,6,8,9,9,11,7,17,6,19,3,2,2,17,11,7,17,1,7,6,12,13,7,9,8,17,7,1,7,9,8,2,13,11,7,13,7,2,9,3,17,11,7,13,7,9,3,8,18,7,4,17,1,7,9,19,7,5,8,1,,78,9,11,7,9,12,9,8,6,7,13,6,8,13,7,9,11,7,9,8,7,8,1,7,8,7,9,13,9,13,13,13,13,17,9,5,13,13,13,13,19,9,2,17,2,9,17,9,5,8,1,7,9,6,11,7,8,7,13,13,17,8,9,1,7,8,9,1179,18,13,4,13,13,13,13,12,11,7,12,11,7,12,1,17,12,8,9,2,7,2,7,1,7,2,7,8,9,17,2,9,13,5,8,9,6,8,7,9,1,7,9,13,18,8,8,1,7,9
13,13,9,7,9,1,7,8,9,13,9,7,9,1,7,8,9,6,8,1,12,13,11,13,6,8,9,5,9,13,1,11,12,13,13,13,5,8,9,6,8,7,9,1,9,13,4,8,8,1,11,12,13,4,9,9,6,6,5,5,4,4,3,3,11,12,8,2,5,12,11,7,6,3,9,13,13,13,13,13,9,2,2,8,8,1,1,7,6,8,9,9,11,1,6,5,3,2,2,1,11,1,1,6,12,13,7,9,8,1,7,1,9,8,2,13,11,13,7,2,9,3,1,11,13,7,9,3,8,4,7,4,1,1,9,5,7,5,8,1,8,9,11,9,12,9,8,6,7,13,6,8,13,7,9,11,9,8,7,8,1,8,7,9,13,9,13,13,13,13,1,9,5,13,13,13,13,5,9,2,1,2,9,1,9,5,8,1,9,6,11,8,7,13,13,1,8,9,1,8,9,11,9,4,13,4,13,13,13,13,12,11,12,11,12,11,12,8,9,2,7,2,7,1,2,7,8,9,1,2,9,13,5,8,9,6,8,7,9,1,9,13,4,8,8,1,9,6,8,1,12,13,11,13,6,8,9,5,9,13,1,11,12,13,13,13,5,8,9,6,8,7,9,1,9,13,4,8,8,1,11,12,13,4,9,9,6,6,5,5,4,4,3,3,11,12,8,2,5,12,11,7,6,3,9,13,13,13,13,13,9,2,2,8,8,1,1,7,6,8,9,9,11,1,6,5,3
14,13,11,7,14,14,14,9,1,7,8,9,6,14,14,14,8,1,12,13,11,13,6,8,14,11,14,14,9,5,9,13,1,11,12,13,14,13,14,13,5,8,9,6,8,7,14,9,1,9,13,4,8,14,8,1,11,12,13,4,11,14,14,14,9,6,6,5,5,4,4,3,14,14,14,14,14,3,11,12,8,2,5,12,11,14,7,6,3,11,13,13,14,13,13,13,9,2,2,8,8,14,1,1,7,6,8,9,14,9,11,1,6,5,3,2,2,1,14,11,1,1,6,12,13,7,9,14,11,8,1,7,1,9,8,2,13,11,13,7,2,9,3,14,1,11,13,7,9,3,8,14,4,7,4,1,1,9,5,14,7,5,8,1,8,9,11,9,12,9,8,14,6,7,13,6,8,13,7,9,11,11,9,8,14,7,8,1,8,7,9,13,9,13,13,14,13,13,1,9,5,14,14,14,5,9,2,14,2,11,1,9,5,8,1,9,6,11,8,7,14,14,1,8,9,1,8,9,11,9,4,13,4,13,13,14,13,12,11,14,11,12,11,14,8,9,2,7,12,7,11,2,7,8,9,11,2,9,13,5,8,9,6,8,7,9,1,9,13,14,8,8,1,9,14,14,14
15,2,1,11,9,5,4,15,15,3,4,4,4,2,15,9,1,11,1,3,5,1,1,3,12,4,13,2,6,11,13,7,13,14,12,6,15,3,1,7,1,8,1,11,1,3,13,1,9,14,13,11,8,9,13,15,3,9,3,7,1,1,8,11,12,6,7,13,6,13,1,2,13,1,12,2,1,14,2,5,4,7,9,14,9,8,5,6,11,1,3,4,12,4,1,1,14,14,1,11,15,3,15,13,5,7,12,5,8,5,11,8,9,11,1,15,1,3,4,14,1,1,15,5,14,6,9,7,7,11,8,6,15,1,5,8,2,1,3,15,3,6,14,8,15,3,14,3,11,4,3,13,12,1,12,1,4,13,5,9,6,14,15,14,6,5,8,12,4,13,4,15,15,8,5,14,6,13,7,7,6,13,6,1,11,3,4,15,15,1,15,14,6,2,5,7,1,11,4,12,7,13,13,6,1,14,13,3,7,3,15,15,5,3,15,14,2,3,15,7,4,5,6,14,12,12,15,14,9,1,13,2,11,15,14,11,3,5,7,1,1,14,6,9,5,9,9,2,15,13,3,11,12,4,13,14,2,11,14,9,15
15,1,8,8,2,7,12,14,15,15,15,1,5,1,12,3,2,2,1,15,12,1,1,14,8,8,13,9,12,12,11,15,15,15,4,2,15,1,7,5,15,15,8,8,1,6,7,8,1,15,1,11,1,15,2,2,8,15,8,7,5,1,15,15,15,8,12,1,3,5,6,6,3,12,15,14,15,9,3,14,3,15,5,1,6,15,13,3,4,3,7,1,15,2,7,3,8,13,5,13,13,13,14,1,12,15,11,4,1,3,12,3,13,15,11,12,15,15,15,7,6,13,5,3,14,6,14,1,4,15,6,11,8,6,7,15,2,4,1,5,6,1,3,15,3,1,14,1,15,5,9,1,14,15,2,3,9,11,13,3,2,15,15,15,1,1,12,15,9,9,12,8,1,4,9,15,15,15,11,8,7,1,8,11,13,6,11,15,1,12,5,4,14,9,12,1,4,15,14,8,9,14,7,9,15,15,15,3,3,13,3,8,11,4,9,1,14,4,2,1,9,7,7,15,9,11,14,2,1,12,11,1,1,15,5,5,1,3,15,5,6,12,11,1,15,15,15,4,11,1,7,6,5,9,15,4,13,1,11,7,4,7,7,11,15,8,14,9,6,11,15,6,6,13,8,2,8,15,15,15,15,12,8,1,2,1,13,14,8,15,9,9,2,14,15,15,15,9,14,4,13,12
20