
0,0,0,0,0,0,0,0,0,0,0,0,0,0,0,0,0,0,0,0,0,0,0,0,0,0,0,0,0,0,0,0,0,0,0,0,0,0,0,0,0,0
0,1,0,1,1,0,0,1,1,1,0,0,0,1,1,0,1,1,1,0,1,0,1,1,1,1,0,1,1,0,1,0,0,0,1,0,1,1,1,1,0,1,1,0,0,0,1,1,1,0,1,1,0,0,1,1,1
1,1,1,0,0,1,1,1,1,1,0,0,0,1,1,0,1,0,1,0,1,0,1,1,1,1,0,1,1,1,0,0,0,1,1,1,0,0,0,0,1,1,1,1,1,1,1,1,1,1,0,0,1,1,0,1,0,1,0,1,0,0,1,1,1,1,1,0,0,0
0,0,1,1,0,2,0,0,1,1,2,0,0,2,0,1,0,1,2,1,2,1,0,1,2,1,2,1,1,1,1,0,0,0,1,2,1,2,2,2,0,1,1,1,2,1,2,1,2,1,2,0,1,2,0,1,2,0,1,1,1,1,1,1,0,0,2,2,2,0,1,0,1,1,1,2,2,2,1,0,1,2,0,1,2,0,1,2,2,2,2,2,0
16,2,0,1,2,2,0,1,1,1,2,1,2,0,0,1,2,1,1,0,0,1,0,1,0,2,0,1,1,1,2,0,1,2,0,2,2,2,2,16,0,0,2,2,2,1,2,2,1,2,0,2,1,2,0,1,2,2,1,2,1,0,0,1,0,2,2,2,0,2,1,0,1,2,2,2,1,2,0,2,0,1,16,2,1,0,0,1,2,1,2,2,2,1,2,0,1,2,0,1,2,2,1,0,2,1,2
2,1,1,1,3,0,0,0,3,3,3,1,1,2,2,1,1,3,3,3,3,0,2,0,1,3,3,3,3,1,2,3,0,0,0,3,0,2,2,2,2,3,3,3,3,3
3,3,3,2,2,1,3,2,1,2,3,0,0,0,1,2,3,2,1,3,3,2,1,3,3,3,2,2,1,2,3,0,3,0,0,0,0,0,3,2,3,1,3,0,2,1,3,0,2,2,2,3,3,3,2,3,1,3,0,0,2,3,2,1,3,2,1,0,2,1,3,0,2,1,3,0,2,3,2,3,1,0,3,1,1,1,2,1,2,1,2,0,3,3,3,0,2,3,0,1,2,1,2,3,3,3,2,3,2,3,2,1,2,3,0
3,0,1,2,2,1,2,0,1,0,3,0,3,3,3,0,1,0,3,0,1,0,2,0,3,0,1,1,1,2,1,2,1,3,1,2,1,3,1,0,0,0,1,2,1,2,2,2,3,2,1,2,1,0,2,1,0,1,2,0,3,0,2,3,0,3,0,3,2,0,1,3,0,1,3,0,2,3,0,1,2,3,0,1,2,0,3,2,1,0,2,3,0,1,3,3,3,3,3,2,1,2,1,3,2,3,3,3,2,3,2,1,0,1,0,1,0,1,0,2,0,3,3,2
0,1,2,3,4,0,4,0,1,0,2,4,0,2,4,3,0,4,1,2,4,2,3,1,2,4,4,4,4,4,1,2,1,3,1,2,0,4,0,4,4,4,0,1,4,2,4,0,4,4,4
4,3,0,1,4,2,16,2,4,1,4,4,2,4,0,1,4,0,3,4,0,4,3,4,1,2,4,3,16,3,0,1,3,2,4,3,4,3,2,0,3,4,0,1,0,2,0,3,0,1,1,1,2,4,1,16,2,1,3,1,4,2,1,3,1,0,0,4,4,0,1,4,2,1,2,2,4,2,3,4,2,1,4,2,1,4,16,4,4,4,4,4,4,0,2,4,4,1,0,1,2,0,3,0,16,2,3,0,3,0,3,2,0,1,3,4,4,0,1,3,0,4,2,3,0,1,2,3,4,16,0,1,4,0,3,2,4,1,0,4,4,4,2,3,0,1,3,3,3,4,4,4,4,4,16,3,3,2,1,2,1,3,2,3,3,3,2,3,4,4,2,1,0,4,1,0,1,4,0,1,0,16,2,0,3,3,2,4,0
5,0,1,2,3,4,0,5,5,4,0,1,0,2,4,0,2,4,3,5,5,0,5,4,1,5,2,4,2,3,1,5,2,4,5,5,5,5,4,5,4,4,1,2,1,0,1,2,0,4,3,4,5,2,0,1,5,2,4,0,4,5,5
5,4,5,2,1,0,0,1,2,0,1,5,4,5,0,1,0,4,5,2,4,3,3,4,3,5,3,2,3,1,0,0,0,1,0,1,1,1,2,4,2,4,2,5,2,5,5,3,2,5,4,1,2,5,3,0,2,0,1,5,4,2,0,3,4,3,4,3,5,3,2,1,2,4,1,5,2,1,4,3,0,1,4,2,3,0,1,4,2,5,0,3,2,1,4,5,2,1,4,5,4,5,4,5,2,0,1,0,5,5,5,5,4,1,2,1,2,0,1,2,1,4,2,1,0,0,0,1,2,0,1,3,0,0,0,0,0,1,4,1,5
0,3,0,2,0,4,5,4,5,2,1,0,5,0,2,1,2,0,4,1,5,4,3,2,5,0,1,5,0,4,0,5,2,1,4,3,3,1,0,4,3,5,5,1,0,0,3,2,3,1,0,0,5,0,1,0,4,1,1,1,5,2,4,1,0,2,4,1,2,5,2,5,5,4,3,2,1,0,5,4,1,5,2,5,3,0,2,0,1,5,2,0,1,4,2,0,1,3,2,0,1,2,4,2,0,5,5,5,3,4,3,4,3,5,3,2,1,2,5,4,1,5,5,2,5,1,4,3,0,1,5,4,2,3,0,1,5,5,4,2,5,0,3,2,1,4,5,2,1,4,5,4,5,4,5,2,0,1,0,5,5,5,5,4,1,2,5,1,2,4,0,1,2,3,1,4,5,2,1,0,5,0,4,0,1,2,0,5,1,3,0,5,0,0,5,0,0,1,4,1,5
6,0,1,0,6,6,5,6,5,0,4,6,3,2,1,0,1,2,1,3,1,4,6,1,5,1,6,1,2,3,6,0,6,4,5,3,2,1,0,6,0,4,3,2,1,2,3,4,3,2,1,6,6,6,0
0,0,0,0,0,17,6,5,6,5,6,5,6,4,0,6,5,6,6,0,0,0,0,0,0,0,0,6,3,6,2,6,1,0,0,0,0,0,6,0,0,0,6,1,6,1,5,1,4,1,2,1,3,0,0,0,0,0,17,1,6,1,5,1,6,0,0,0,0,0,0,0,0,0,0,0,0,4,5,4,6,4,3,4,5,4,4,4,6,5,6,5,6,0,0,0,0,0,0,5,6,1,6,1,5,0,5,0,4,0,6,6,6,6,0,0,0,0,0,0,0,6,5,0,5,4,0,4,3,0,3,2,0,0,0,17,0,0,0,2,1,0,1,6,6,6,6,6,6,0,0,0,0,0,0,5,5,5,5,5,0,0,0,0,0,0,4,4,4,4,0,0,0,0,0,0,0,0,0,0,0,0,3,3,3,2,2,1,0,0,0,6,6,0,4,0,0,0,0,0,0,5,4,6,0,5,6,2,0,6,4,3,0,5,6,5,6,5,4,5,6,3,2,5,6,2,1,5,6,3,2,4,0,0,0,0,0,17,5,2,1,5,6,6,5,6,5,6,3,5,3,6,2,4,1,5,2,1,4,2,0,0,0,0,0,0,0,1,5,0,1,6,6
6,5,6,5,6,0,0,0,0,0,0,4,6,5,6,4,0,0,0,0,0,0,6,4,6,6,0,0,0,0,0,0,3,6,3,5,3,4,0,0,0,0,0,0,3,6,3,5,3,6,3,5,3,4,3,2,3,2,3,2,3,0,0,0,0,0,0,6,3,6,3,0,1,0,6,0,5,0,4,0,0,0,0,5,0,6,0,4,0,3,0,5,0,6,0,1,0,0,0,0,2,0,5,0,4,3,0,6,0,6,5,0,2,0,3,0,5,0,0,0,0,0,0,0,1,0,6,0,5,0,4,0,3,0,6,0,0,0,0,0,0,0,5,0,6,0,4,0,5,0,3,0,6,0,5,0,4,0,5,6,6,6,6,0,0,0,0,0,0,6,6,6,6,5,4,5,5,6,0,0,0,0,0,0,5,6,3,2,5,3,4,0,1,5,0,1,5,0,0,0,0,0,0,0,6,0,4,6,3,5,2,1,4,6,5,3,0,4,6,5,3,0,2,1,5,6,2,0,1,6,6,5,4,5,6,3,2,5,6,3,2,5,4,1,2,5,6,3,0,1,4,5,2,0,1,5,6,3,0,2,4,1,0,5,6,3,2,0,1,4,5,0,1,5,2,0,1,4,6
7,0,7,0,0,0,0,0,0,6,0,6,0,0,0,0,0,0,5,0,5,0,0,0,0,0,0,4,0,4,0,0,0,0,0,0,3,0,3,0,0,0,0,0,0,2,0,2,0,0,0,0,0,0,1,0,1,0,0,0,0,0,0,0,7,0,0,0,0,0,0,0,1,7,1,2,7,2,0,0,0,0,0,0,3,7,3,0,0,0,0,0,0,4,7,4,0,0,0,0,0,0,5,7,5,0,0,0,0,0,0,0,7,6,7,7,7,0,1,0,1,0,1,0,1,0,2,7,2,7,1,2,7
0,7,1,2,7,6,0,6,0,3,0,0,0,0,0,0,5,7,6,5,6,7,5,6,4,0,6,5,6,3,0,0,0,0,0,0,1,2,1,3,2,1,6,0,7,7,0,0,0,0,0,0,0,6,3,6,2,6,1,0,7,0,0,0,0,0,0,0,0,7,0,0,0,0,0,0,0,0,7,1,1,2,1,5,4,6,0,0,7,0,6,1,2,1,2,3,5,4,6,0,0,0,0,0,0,7,7,6,1,5,1,4,7,1,2,0,7,6,5,4,3,2,1,0,0,0,0,0,0,3,1,6,0,0,0,0,0,0,1,5,7,1,6,4,5,0,0,0,0,0,0,7,4,6,0,7,1,0,0,0,0,0,0,7,4,3,4,5,4,7,7,0,4,4,6,5,0,0,0,0,0,0,6,5,0,3,5,7,5,6,0,0,0,0,0,0,1,6,7,5,0,5,0,0,0,0,0,0,0,4,0,6,7,6,6,0,6,5,0,0,0,0,0,0,0,5,4,0,4,3,0,3,2,0,2,1,0,0,0,0,0,0,0,1,7,7,7,7,7,7,7,0,0,0,0,0,0,7,6,6,6,6,6,6,0,0,0,0,0,0,7,5,5,5,5,5,0,0,0,0,0,0,7,4,4,4,4,7,0,0,0,0,0,0,3,3,3,7,2,2,7,1,0,0,0,6,7,0,4,7,5,4,6,0,0,0,0,0,0,0,5,6,2,0,7,6,4,3,0,5,6,5,6,5,4,0,0,0,0,0,0,5,0,1,7,7,7,6,3,2,5,6,0,0,0,0,0,0,2,1,5,6,3,2,4,5,2,1,0,0,0,0,0,0,5,6,6,5,6,5,6,3,5,7,7,7,0,0,0,0,0,0,3,6,2,4,1,5,7,2,3,1,4,2,0,7,1,5,0,0,0,0,0,0,0,1,6,6,7,7,0,7,1,7,3
7,0,7,8,6,8,0,0,0,0,0,0,0,6,8,5,0,5,8,6,8,0,0,0,0,0,0,7,4,8,8,1,0,0,0,0,0,0,0,4,3,0,8,2,5,7,6,0,0,0,0,0,0,3,2,0,2,8,8,1,0,1,7,0,0,0,0,0,0,6,8,0,7,0,8,1,0,0,0,0,0,0,7,1,8,2,7,2,0,0,0,0,0,0,3,7,3,0,0,0,0,0,0,8,4,7,4,5,7,5,0,0,0,0,0,0,8,8,8,0,0,0,0,0,0,6,7,6,8,7,8,7,8,8,7,0,1,8,0,0,0,0,0,0,0,1,0,8,1,8,0,1,0,8,2,7,2,7,1,2,7,8,8,8
17,8,6,8,0,0,0,0,0,0,17,7,1,7,8,0,0,0,0,0,0,8,6,0,6,8,0,0,0,0,0,0,5,0,5,8,4,17,8,6,8,3,0,0,0,0,0,0,8,4,8,8,0,0,0,0,0,0,5,0,0,17,0,0,0,0,7,6,8,4,7,0,4,3,8,5,0,0,0,0,0,17,4,8,7,6,2,8,1,8,0,0,0,0,0,0,7,4,8,6,5,0,3,0,0,0,0,17,0,0,8,7,5,8,6,0,0,0,0,0,0,5,4,8,2,8,5,6,3,2,4,8,2,0,0,0,17,0,0,1,2,5,4,8,7,8,0,2,0,0,0,0,0,0,1,0,1,8,17,7,0,0,0,0,0,0,1,4,5,1,2,4,0,0,0,0,17,0,8,0,0,0,0,0,0,5,3,2,0,1,5,7,4,0,8,4,0,0,0,0,0,0,5,0,1,8,4,2,0,3,17,0,0,0,0,0,0,0,0,0,0,0,0,4,8,4,2,8,0,7,0,8,2,1,5,8,0,0,0,0,0,0,4,2,0,3,17,6,8,4,8,7,0,0,0,0,0,0,5,8,7,5,0,0,0,0,0,0,2,1,8,5,2,8,8,8,8,17,0,0,0,0,0,8,8,8,8,8,0,0,0,0,0,0,6,8,4,2,5,8,4,0,0,0,0,0,0,8,3,2,4,17,0,1,8,0,1,8,0,0,0,0,0,0,0,1,8,0,1,8,6,2,4,7,5,1,7,8,0,0,0,17,0,0,4,5,2,1,2,4,5,8,0,0,0,0,0,0,7,5,8,7,4,1,8,2,3,8,0,0,0,0,0,17,6,5,8,7,8,5,0,0,0,0,0,0,7,8,1,0,2,8,4,1,0,0,0,0,0,0,0,17,5,8,6,3,2,5,8,4,1,2,5,4,0,0,0,0,0,0,2,7,8,2,4,8,7,6,5,8,0,0,17,0,0,0,2,3,8,4,0,1,8,2,0,0,0,0,0,0,0,1,8,0,0,0,0,8,4,5,17,0,0,0,0,0,0,1,3,4,5,8,6,5,7,2,0,0,0,0,0,0,0,8,0,4,5,8,4,17,8,0,0,0,0,0,0,6,8,4,2,8,0,1,8,2,1,8,0,0,0,0,0,0,3,8,2,8,1,8,17,4,2,4,1,3,5,4,8,4,7,5,7,0,0,0,0,0,0,8,5,1,0,8,7,5,4,8,5,17,0,3,2,1,0,4,1,2,3,7,3,4,7,8,8,0,0,0,0,0,0,0,17,8,0,1,8,0,1,0,1,8,0,2,7,8,2,7,1,8,2,7
6,5,8,0,1,0,0,0,0,0,0,2,4,8,7,6,5,6,7,5,8,8,0,0,0,0,0,0,8,6,4,0,8,7,6,5,8,6,0,0,0,0,0,0,0,5,8,6,7,8,7,6,0,7,8,7,0,0,0,0,0,0,0,6,3,6,2,6,1,8,0,7,0,0,7,0,8,1,8,0,0,0,0,0,0,4,8,5,2,8,0,6,0,0,7,8,0,6,0,0,0,0,0,0,1,8,4,7,5,8,0,0,0,0,0,0,6,2,1,8,6,1,5,1,4,7,0,1,5,8,0,0,0,0,0,0,7,5,8,6,5,4,8,5,7,8,2,0,8,1,0,0,0,0,0,0,2,8,1,3,8,0,0,0,0,0,0,1,6,8,1,5,8,7,1,6,8,0,0,0,0,0,0,8,4,0,0,0,0,0,0,8,5,7,4,6,8,0,7,1,8,0,0,0,0,0,0,7,4,8,3,4,0,0,0,0,0,0,8,5,4,7,8,7,0,4,8,4,6,5,6,5,8,6,0,0,0,0,0,0,5,8,6,8,0,0,0,0,0,0,1,6,8,1,5,7,8,0,0,0,0,0,0,0,8,7,8,6,4,5,0,0,0,0,0,0,0,4,0,7,8,4,7,5,8,2,1,8,3,0,8,6,6,6,0,0,0,0,0,0,6,8,0,7,6,5,8,0,0,0,0,0,0,0,4,8,3,8,5,4,0,4,8,3,0,0,0,0,0,0,0,3,2,8,0,2,1,0,1,7,8,8,0,1,0,0,0,0,0,0,7,7,0,1,4,8,7,7,7,6,8,6,8,0,1,5,4,7,0,8,0,0,0,0,0,0,6,6,6,6,7,5,5,8,5,4,6,7,5,2,1,4,0,0,0,0,0,0,3,0,5,4,5,4,1,8,5,4,2,1,4,8,5,0,0,0,0,0,0,5,5,0,0,1,8,0,0,0,0,0,1,4,0,0,0,0,0,8,7,5,4,4,5,4,6,2,4,7,3,2,5,8,4,4,0,0,0,0,0,0,2,1,4,8,2,0,1,4,4,7,8,0,0,0,0,0,0,4,5,6,2,1,4,7,8,5,4,1,5,8,0,0,0,0,0,0,7,4,1,5,4,7,6,3,8,0,1,4,0,0,0,0,0,0,5,0,2,4,7,5,2,0,3,7,8,7,8,7,0,0,0,0,0,0,4,5,7,6,2,1,0,1,4,5,0,6,7,0,0,0,0,0,0,8,5,2,0,1,4,5,2,2,7,1,8,0,0,0,0,0,0,8,0,0,8,6,6,0,4,8,4,6,0,5,6,0,0,0,0,0,0,8,0,6,4,3,0,8,0,6,5,6,5,4,5,0,7,8,7,8,7,8,7,0,0,0,0,0,0,6,2,1,5,6,0,1,8,0,2,8,0,3,3,2,4,5,2,1,5,6,6,3,5,8,0,0,0,0,0,0,7,5,4,8,7,5,2,1,6,8,7,1,0,1,0,0,0,0,0,0,0,1,8,0,2,4,5,8,6,7,7,0,7,1,7,3
9,7,9,0,0,0,0,0,0,0,7,8,9,6,8,0,6,8,9,0,0,0,0,0,0,5,0,9,5,8,9,0,0,0,0,0,0,4,6,8,7,9,9,4,8,0,0,0,0,0,0,4,8,1,0,4,9,0,0,0,0,0,0,9,3,0,8,2,5,7,6,3,9,9,2,0,0,0,0,0,0,0,2,8,8,1,0,1,7,6,8,9,9,0,7,0,9,0,0,0,0,0,0,8,1,7,1,9,8,2,7,2,9,3,7,9,3,8,0,0,0,0,0,0,4,7,4,9,5,7,5,8,0,0,0,0,0,0,8,9,9,9,8,0,0,0,0,0,0,6,7,6,8,7,9,9,8,0,0,0,0,0,0,7,8,8,7,9,9,0,1,8,0,0,0,0,0,0,0,9,1,0,8,9,1,9,0,0,0,0,0,0,8,0,1,0,8,9,0,0,0,0,0,0,2,7,2,7,1,2,7,8,9,8,8,9,9,9
9,7,9,0,0,0,0,0,0,0,4,7,8,9,6,8,0,6,8,9,5,0,0,0,0,0,0,0,9,5,8,9,6,8,7,9,0,0,0,0,0,0,9,4,8,8,1,0,4,9,0,0,0,0,0,0,9,3,0,8,2,5,7,6,3,9,0,0,0,0,0,0,4,9,2,0,2,8,8,0,0,0,0,0,0,1,0,1,7,6,8,9,9,0,7,0,9,8,1,7,1,9,0,0,0,0,0,0,8,2,7,2,9,3,7,9,0,0,0,0,0,0,3,8,4,7,9,7,9,0,7,8,9,6,8,0,0,0,0,0,0,0,0,0,0,0,0,0,6,8,9,5,0,9,5,8,9,6,8,7,9,9,4,8,0,0,0,0,0,0,8,1,0,4,9,0,0,0,0,0,0,9,3,0,8,2,5,7,6,3,9,9,2,0,2,8,0,0,0,0,0,0,1,8,1,0,1,7,6,8,9,9,0,7,0,9,8,1,0,0,0,0,0,0,7,1,9,8,2,7,2,9,3,7,9,3,8,4,7,4,9,5,0,0,0,0,0,0,7,5,8,8,9,9,9,8,6,7,6,8,7,9,0,0,0,0,0,0,9,8,7,8,8,7,9,9,0,1,8,0,9,1,0,8,9,1,0,0,0,0,0,0,9,8,0,1,0,8,9,2,7,2,7,1,2,7,8,9,0,0,0,0,0,0,8,8,9,9,9,4,9,5,7,5,8,0,8,0,7,0,0,0,0,0,0,0,0,8,9,9,9,8,0,0,0,0,0,0,6,7,0,0,0,0,0,0,6,8,7,9,0,0,0,0,0,0,9,8,7,8,8,7,9,9,0,1,8,0,0,0,0,0,0,0,9,1,0,8,9,1,9,8,0,1,0,8,9,2,0,0,0,0,0,0,7,2,7,1,2,7,8,9,8,8,9,0,0,0,0,0,0,9,9
7,9,0,7,9,8,0,0,0,0,0,0,9,7,9,0,7,8,9,6,8,0,6,8,0,0,0,0,0,0,9,5,0,9,5,8,9,6,8,0,0,0,0,0,0,7,9,9,4,8,8,0,0,0,0,0,0,1,0,4,9,9,0,0,0,0,0,0,3,0,8,2,5,0,0,0,0,0,0,4,7,6,3,9,9,2,0,2,8,0,0,0,0,0,0,8,1,0,1,7,6,8,9,9,0,0,0,0,0,0,0,7,0,9,8,1,7,1,9,8,2,7,2,01,0,0,0,0,0,9,3,7,9,3,8,4,7,4,9,0,0,0,0,0,0,5,7,5,8,8,9,9,9,0,0,0,0,0,0,8,6,7,6,8,7,9,9,0,0,0,0,0,0,8,7,8,8,7,9,9,0,1,8,0,9,1,0,0,0,0,0,0,0,4,8,9,1,9,8,0,0,0,0,0,0,0,1,0,8,9,2,7,2,7,0,2,7,8,9,8,8,9,9,0,0,0,0,0,0,9,6,8,0,6,8,9,5,0,5,8,6,0,0,0,0,0,0,8,7,9,9,4,8,8,1,0,4,9,9,3,0,8,2,0,0,0,0,0,0,5,9,7,6,3,9,9,2,0,2,8,8,1,0,0,0,0,0,0,0,1,7,6,8,9,9,0,7,0,8,9,0,0,0,0,0,0,1,7,9,1,9,8,2,0,0,0,0,0,0,7,2,9,3,7,3,8,4,7,4,9,5,0,0,0,0,0,0,7,5,8,8,8,6,7,6,8,0,0,0,0,0,0,7,9,9,8,7,8,9,8,7,9,0,0,0,0,0,0,9,0,1,9,9,8,0,9,1,0,0,0,0,0,0,0,0,0,0,0,0,0,9,0,0,9,0,0,9,0,0,9,0,0,0,0,0,0,0,0,8,9,1,8,0,9,1,0,8,2,7,9,2,0,0,0,0,0,0,7,1,2,7,8,9,8,9,8,9,0,0,0,0,0,0,2,1,0,5,9,0,2,1,2,0,0,0,0,0,0,9,0,4,1,5,9,9,9,5,0,0,0,0,0,0,0,6,0,4,9,0,3,0,9,5,0,6,0,0,0,0,0,0,0,9,1,0,0,0,0,9,9,9,9
18,9,7,4,6,1,3,0,0,0,0,0,0,0,9,0,7,10,10,0,0,0,0,0,0,10,8,9,6,0,0,0,0,0,0,10,8,0,0,0,0,0,0,0,6,10,18,9,5,10,0,0,0,0,0,0,0,9,10,5,8,9,6,8,7,9,10,0,0,0,0,0,0,9,4,8,8,10,1,0,4,10,10,9,9,0,0,0,0,0,0,3,10,0,10,8,2,5,7,10,10,6,3,9,10,10,0,0,0,0,0,0,9,10,2,0,2,8,10,18,1,0,1,7,6,10,0,0,0,0,0,0,8,9,9,0,7,10,0,10,9,8,1,7,0,0,0,0,0,0,0,18,0,0,0,0,10,1,9,8,10,2,7,2,9,10,3,7,9,3,8,10,4,7,9,7,0,0,0,0,0,0,9,0,10,7,18,9,10,6,8,10,0,0,0,0,0,0,0,6,8,10,9,5,0,10,9,5,8,10,9,0,0,0,0,0,0,6,8,7,9,10,9,10,10,10
10,10,9,7,9,0,0,0,0,0,0,0,7,10,10,10,8,9,0,0,0,0,0,0,6,10,9,7,9,0,7,0,0,0,0,0,0,10,10,10,8,9,6,0,0,0,0,0,0,10,8,0,6,10,8,9,5,10,0,0,0,0,0,0,0,9,10,5,8,9,6,8,7,9,10,9,4,8,0,0,0,0,0,0,8,10,1,0,4,10,10,9,9,3,10,0,0,0,0,0,0,0,10,8,2,5,7,10,10,6,3,9,10,10,9,10,0,0,0,0,0,0,2,0,2,8,10,8,1,0,1,7,6,10,8,9,0,0,0,0,0,0,9,0,7,10,0,10,9,8,1,7,10,1,9,8,0,0,0,0,0,0,10,2,7,2,9,10,3,7,9,3,8,10,4,7,9,0,0,0,0,0,0,7,9,0,10,7,8,9,10,6,8,10,0,6,8,0,0,0,0,0,0,10,9,5,0,10,9,5,8,10,9,6,8,7,9,10,0,0,0,0,0,0,9,10,10,10,10,8,0,6,10,8,9,5,10,0,9,0,0,0,0,0,0,10,5,8,9,6,8,7,9,10,9,4,8,8,10,1,0,4,0,0,0,0,0,0,10,10,9,9,3,10,0,10,8,2,5,7,10,10,6,3,9,0,0,0,0,0,0,10,10,9,10,2,0,2,8,10,8,1,0,1,7,6,10,0,0,0,0,0,0,8,9,9,0,7,10,0,10,9,8,1,7,10,1,9,8,10,0,0,0,0,0,0,4,2,7,2,9,10,3,7,9,3,8,10,4,7,9,0,0,0,0,0,0,0,0,0,0,0,0,7,9,0,10,7,8,9,10,6,8,10,0,6,8,10,9,0,0,0,0,0,0,5,0,10,9,5,8,10,9,6,8,7,9,10,0,0,0,0,0,0,9,10,10,10
10,10,10,9,7,9,0,0,17,0,0,0,0,7,10,10,10,8,9,6,10,0,0,0,0,0,9,7,9,0,7,10,10,10,0,0,0,0,0,0,8,9,6,10,8,17,6,10,8,0,0,0,0,0,0,9,5,10,0,9,10,5,8,9,6,8,7,9,0,0,0,0,0,0,10,9,4,8,8,10,1,0,4,10,10,9,9,3,10,0,10,8,0,0,0,17,0,0,2,5,7,10,10,6,3,9,10,10,9,10,2,0,2,8,10,8,1,0,1,7,6,10,8,9,9,10,0,0,0,0,0,17,6,3,9,10,10,9,10,2,0,2,8,10,8,1,0,1,7,0,0,0,0,0,0,6,10,8,9,9,0,7,10,0,10,9,8,1,7,10,1,9,8,10,2,7,2,0,0,0,0,0,17,9,10,3,7,9,3,8,10,4,7,9,7,9,0,10,7,8,9,10,6,8,10,0,0,0,0,0,0,0,6,8,10,9,5,0,10,9,5,8,10,9,6,8,7,9,10,0,0,0,0,0,0,0,0,17,0,0,0,9,10,10,10,0,7,10,0,10,9,8,1,7,10,1,9,8,10,2,0,0,0,0,0,0,7,2,9,10,3,7,9,3,8,10,4,7,9,7,9,0,10,7,8,9,10,6,8,17,0,0,0,0,0,10,0,6,8,10,9,5,0,10,9,5,8,10,9,6,8,7,9,10,9,0,0,0,0,0,0,10,10,10,10,8,0,6,10,8,9,5,10,0,9,10,5,8,0,0,0,0,0,17,9,6,8,7,9,10,9,4,8,8,10,1,0,4,10,10,9,9,3,10,0,0,0,0,0,0,0,0,0,0,0,0,17,10,8,2,5,7,10,10,6,3,9,10,10,9,10,2,0,2,0,0,0,0,0,0,8,10,8,1,0,1,7,6,10,8,9,9,0,7,10,0,10,0,0,0,0,0,17,9,8,1,7,10,1,9,8,10,2,7,2,9,10,3,7,9,0,0,0,0,0,0,3,8,10,4,7,9,7,9,0,10,7,8,9,10,6,8,10,0,0,0,0,0,0,0,6,8,10,9,5,0,17,9,5,8,10,9,6,8,7,0,0,0,0,0,0,9,10,9,10,10,10
0,1,4,11,10,9,7,4,11,5,0,0,0,0,0,0,11,7,11,2,9,0,7,10,0,0,0,0,0,0,11,1,2,11,2,3,11,0,0,0,0,0,0,4,5,0,0,0,0,0,0,10,10,8,9,6,10,8,0,0,0,0,0,0,0,11,1,11,1,6,10,8,9,5,10,0,9,10,11,11,1,2,7,1,3,0,0,0,0,0,0,4,11,5,8,9,6,8,7,9,10,9,11,1,11,4,11,0,0,0,0,0,0,5,11,6,11,11,11,11,11,4,8,8,10,1,0,0,0,0,0,0,0,4,5,11,6,11,10,10,9,9,3,10,0,10,1,2,3,4,5,6,7,8,9,10,0,0,0,0,0,0,0,0,0,0,0,0,11,1,8,2,5,7,10,10,6,3,9,10,10,9,10,0,0,0,0,0,0,2,1,2,3,11,0,2,8,10,8,1,0,1,7,6,0,11,0,0,0,0,11,11,1,11,0,0,0,0,0,0,10,8,9,9,0,7,10,0,4,9,11,11,4,0,0,0,0,0,0,9,0,11,10,9,8,1,7,10,1,9,8,10,2,7,2,0,0,0,0,0,0,0,11,0,11,0,11,0,11,0,11,9,10,3,7,9,3,8,0,0,0,0,0,0,0,0,0,0,0,0,10,4,7,9,7,9,11,4,11,5,11,2,11,2,11,2,0,0,0,0,0,0,0,10,7,8,9,10,6,8,10,0,1,11,2,11,3,6,8,10,9,5,0,0,0,0,0,0,0,10,9,5,8,10,9,6,11,8,7,9,10,9,11,11,10,0,0,0,0,0,0,10,10
11,0,1,4,11,10,9,7,4,0,0,0,0,0,0,11,5,11,7,11,0,0,0,0,0,0,2,9,0,7,10,0,0,0,0,0,0,11,1,2,11,6,5,6,6,0,0,6,3,6,2,6,1,0,0,0,0,0,2,3,0,0,0,0,0,0,11,4,5,10,0,0,0,0,0,0,10,8,9,6,10,8,0,11,1,11,1,6,10,8,9,5,10,0,0,0,0,0,0,0,9,10,11,11,4,3,0,0,0,0,0,0,4,1,2,4,3,3,11,1,2,7,1,3,4,11,5,8,9,6,8,0,0,0,0,0,0,7,9,10,9,11,1,11,4,11,5,11,6,11,11,11,11,0,0,0,0,0,0,11,4,8,8,10,1,0,4,5,11,6,11,10,10,9,9,3,10,0,0,0,0,0,0,0,10,1,2,3,4,2,0,7,6,5,4,3,2,1,5,6,7,0,0,0,0,0,0,8,9,10,11,1,8,2,5,7,10,10,6,3,9,10,0,0,0,0,0,0,10,9,10,2,1,2,3,11,0,2,8,0,0,0,0,0,0,10,8,1,0,1,7,6,0,11,0,0,0,0,0,0,0,0,0,0,11,11,1,11,10,8,9,5,6,3,2,11,11,11,4,0,0,0,0,0,0,5,11,2,1,5,6,9,0,7,10,0,4,9,11,11,0,0,0,0,0,0,4,9,0,11,10,9,8,1,7,10,1,9,8,10,0,0,0,0,0,0,11,8,6,3,11,2,5,8,11,4,2,7,2,0,0,0,0,0,0,0,11,0,11,0,11,0,11,0,11,9,10,3,7,9,3,8,10,4,7,9,0,0,0,0,0,0,7,9,11,4,11,5,11,2,11,2,11,2,0,10,7,0,0,0,0,0,0,8,9,10,6,8,10,0,1,11,2,11,3,6,8,0,0,0,0,0,0,10,9,5,0,10,9,5,8,10,9,6,11,0,0,0,0,0,0,8,7,9,10,9,11,11,0,0,0,0,0,0,10,10,0,0,0,0,0,0,10,11,2,7,1,2,11,7,8,9,11,8,11,8,11,9,9,9,0,0,0,0,0,0,11,4,9,5,7,5,11,0,11,0,11,2,11,2,0,0,0,0,0,0,11,1,11,11,11,3,11,4
11,0,1,4,11,10,9,7,11,18,8,6,0,0,0,0,0,0,0,11,6,8,11,4,11,5,11,7,11,2,9,0,7,0,0,0,18,0,0,10,11,2,4,3,5,5,1,2,11,2,3,0,0,0,0,0,0,11,4,5,10,10,8,9,6,10,18,0,0,0,0,0,0,0,11,8,1,0,1,7,6,8,9,11,1,11,1,6,10,8,9,5,10,0,0,0,0,0,0,0,9,10,11,18,2,1,4,11,3,0,11,1,4,2,3,1,2,11,7,0,0,0,0,0,0,1,3,4,11,5,8,9,6,8,7,9,10,9,11,18,0,0,0,0,0,0,11,4,11,5,11,6,11,11,11,11,11,4,8,8,10,1,0,4,5,11,6,0,0,0,0,0,0,11,10,18,9,9,3,10,0,10,1,2,3,4,5,6,7,8,9,10,0,0,0,0,0,0,11,1,8,2,5,7,10,10,6,3,9,10,10,9,10,2,18,2,3,0,0,0,0,0,0,11,0,2,8,10,8,1,0,1,7,6,0,11,0,0,0,0,11,11,0,0,0,0,0,0,1,11,10,8,9,9,0,7,18,0,4,9,11,0,0,0,0,0,0,11,4,9,0,11,10,9,8,1,7,10,1,9,8,10,2,7,0,0,0,0,0,18,2,0,11,0,11,0,11,0,11,0,11,9,10,3,7,9,3,0,0,0,0,0,0,8,10,4,7,9,7,9,18,4,11,5,11,2,11,2,11,2,0,0,0,0,0,0,0,10,7,8,9,10,6,8,10,0,1,11,2,11,3,6,8,0,0,0,0,0,0,10,9,5,0,10,9,5,8,10,9,18,11,8,7,9,10,9,11,11,10,0,0,0,0,0,0,10,10,11,0,11,0,11,0,11,9,10,3,7,9,3,8,10,4,7,0,0,0,0,0,0,9,7,9,11,4,11,5,11,2,18,2,11,2,0,10,7,8,0,0,0,0,0,0,9,10,6,8,10,5,11,2,11,6,3,5,8,7,5,4,0,0,0,0,0,0,8,7,5,2,1,6,8,7,11,0,1,0,11,8,0,2,4,5,18,0,0,0,0,0,8,6,7,7,0,7,11,7,3,2,11,2,0,10,7,8,9,10,0,0,0,0,0,0,6,8,10,0,1,11,2,11,3,6,8,10,18,0,9,0,0,0,0,0,0,10,11,11,4,3,4,1,2,4,3,3,0,0,0,0,0,0,11,1,2,7,1,3,4,11
12,0,1,4,11,12,10,9,0,0,0,0,0,0,7,4,11,12,5,11,0,0,0,0,0,0,12,7,11,12,2,9,0,7,10,11,1,0,0,0,0,0,0,12,2,11,2,3,12,11,4,12,5,10,0,0,0,0,0,0,12,10,8,9,6,10,12,8,0,11,1,11,1,12,6,10,0,0,0,0,0,0,8,9,5,10,0,12,9,10,11,12,11,1,2,12,7,0,0,0,0,0,0,1,3,4,11,5,8,9,6,12,8,7,9,12,12,0,0,0,0,0,0,12,10,9,11,1,11,4,11,5,11,12,11,0,0,0,0,0,0,11,10,11,12,4,8,8,12,10,0,4,5,11,6,11,0,0,0,0,0,0,10,10,9,9,3,10,12,12,12,0,10,1,2,0,0,0,0,0,0,3,4,5,6,7,8,9,10,0,0,0,0,0,0,11,0,0,0,0,0,0,4,12,1,8,2,5,7,10,10,0,0,0,0,0,0,6,3,9,12,10,10,9,10,2,1,12,0,0,0,0,0,0,3,11,0,2,8,10,8,1,0,12,1,7,6,0,11,0,0,0,0,0,0,0,0,12,0,0,11,11,12,12,12,11,10,12,9,12,0,0,0,0,0,0,9,0,7,10,0,4,9,11,11,4,9,0,12,12,12,0,0,0,0,0,0,11,10,9,8,1,7,10,1,9,8,10,2,7,12,0,0,0,0,0,0,0,11,0,11,0,11,0,11,0,11,9,10,0,0,0,0,0,0,3,12,7,9,3,8,10,4,12,7,0,0,0,0,0,0,9,7,9,12,11,4,11,12,12,0,0,0,0,0,0,0,12,5,11,2,11,2,11,2,0,10,7,0,0,0,0,0,0,12,8,9,10,6,0,0,0,0,0,0,8,12,10,0,1,11,2,11,0,0,0,0,0,0,0,0,0,0,0,0,3,12,6,8,10,9,5,12,0,10,9,5,8,12,0,0,0,0,0,0,12,10,9,6,11,12,8,7,9,0,0,0,0,0,0,10,9,11,12,10,12,10,12,9,6,3,0
12,12,0,0,0,0,0,0,0,1,4,0,12,10,9,7,4,11,12,5,0,0,0,0,0,0,11,0,0,0,0,0,0,12,7,11,12,2,9,0,7,10,11,1,0,0,0,0,0,0,12,2,11,2,0,0,2,0,1,0,1,2,1,12,10,9,7,4,11,12,5,11,12,7,11,12,2,9,0,0,0,0,0,0,0,7,10,11,1,12,2,11,2,3,12,0,9,0,0,0,0,0,0,8,1,7,12,12,1,9,8,2,7,2,9,11,4,12,5,10,0,0,0,0,0,0,12,10,8,9,6,10,12,8,0,11,1,11,1,12,6,10,8,9,5,10,0,12,0,0,0,0,0,0,9,10,11,12,10,1,9,8,10,2,7,2,9,10,12,3,0,0,0,0,0,0,0,0,0,0,0,0,7,9,11,1,2,12,7,1,3,4,11,5,8,9,6,12,8,7,9,0,0,0,0,0,0,0,0,0,0,0,0,12,1,6,7,5,0,5,0,4,0,6,7,6,12,12,10,9,11,1,11,0,0,0,0,0,0,4,11,5,11,12,11,12,3,11,0,2,8,0,0,0,0,0,0,10,8,1,0,12,1,7,6,0,11,0,0,12,0,0,11,0,0,0,0,0,0,10,11,12,4,8,8,12,10,0,4,5,0,0,0,0,0,0,0,0,0,0,0,0,0,0,0,0,0,0,11,6,11,10,10,0,4,9,11,12,12,0,0,0,0,0,0,12,9,0,7,10,0,4,9,11,11,12,12,11,4,9,0,11,0,0,0,0,0,0,10,10,9,9,3,10,12,12,2,7,8,2,4,8,7,6,0,0,0,0,0,0,5,12,0,10,1,2,3,12,4,5,6,12,7,8,9,12,10,11,12,12,0,0,0,0,0,0,1,8,2,5,7,10,10,6,3,9,12,10,10,9,10,2,1,12,0,0,0,0,0,0,3,11,0,10,3,7,12,9,3,8,10,4,7,9,7,9,12,0,0,0,0,0,0,2,8,10,8,1,0,12,1,7,6,0,11,0,0,12,0,0,11,11,12,12,0,0,0,0,0,0,12,11,10,12,9,12,9,0,7,10,0,4,9,11,6,0,0,0,0,0,0,0,6,5,0,5,4,0,4,3,0,3,2,0,2,1,0,1,12,11,4,9,0,12,12,0,0,0,0,0,0,12,11,10,9,8,1,7,10,1,9,8,10,2,7,12,0,11,0,0,0,0,0,0,0,11,0,11,0,11,0,11,9,10,3,12,7,9,3,8,10,0,0,0,0,0,0,4,12,7,9,7,9,12,11,4,11,12,12,12,5,0,0,0,0,0,0,11,2,11,2,11,2,0,10,7,12,8,9,10,6,8,12,10,0,1,11,2,0,0,0,0,0,0,11,3,12,6,8,10,9,5,12,0,10,9,5,8,12,12,10,9,6,11,12,8,7,9,10,9,11,12,10,12,0,0,0,0,0,0,10,12,9,6,3,0
13,9,7,9,0,10,7,8,9,6,8,10,0,0,0,0,0,0,12,13,0,0,0,0,0,0,11,13,0,6,8,9,5,0,9,13,0,0,0,0,0,0,10,11,12,13,13,0,0,0,0,0,0,13,5,8,9,6,8,7,0,0,0,0,0,0,9,10,9,13,4,8,8,1,0,11,12,13,4,9,9,6,0,6,5,0,0,0,0,0,0,0,5,4,0,4,3,3,11,12,0,8,2,5,12,11,0,0,0,0,0,0,7,6,3,9,0,0,0,0,0,0,13,13,13,13,13,0,0,0,0,0,0,9,2,0,2,8,8,1,0,1,7,0,0,0,0,0,0,6,8,9,9,0,11,10,6,5,0,3,2,0,0,0,0,0,0,0,2,1,0,11,1,10,6,12,13,7,0,9,8,0,0,0,0,0,0,1,7,1,9,8,2,13,11,13,7,2,9,3,10,11,0,0,0,0,0,0,13,7,9,3,8,4,7,4,10,10,9,5,7,5,8,10,8,9,11,9,0,0,0,0,0,0,12,9,8,6,7,13,6,8,13,7,9,11,9,8,7,8,10,8,0,0,0,0,0,0,7,9,13,9,0,13,13,13,13,10,9,5,0,0,0,0,0,0,0,0,0,13,13,0,0,0,0,0,0,13,13,0,5,9,0,2,1,2,9,0,10,9,5,8,10,9,6,11,8,7,13,13,1,8,0,9,10,0,8,9,11,9,4,13,4,0,0,0,0,13,13,13,0,0,0,0,0,0,13,12,11,12,11,12,11,0,12,0,8,9,2,7,2,7,1,2,7,8,9,1,0,0,0,0,0,0,2,0,9,13,5,8,9,6,8,7,9,10,9,13,4,8,8,1,0,9
13,13,9,7,9,0,0,0,0,0,0,0,10,7,8,9,13,9,7,9,0,10,0,0,0,0,0,0,7,8,9,6,8,10,12,13,11,0,0,0,0,0,0,13,0,6,8,9,5,0,9,13,10,11,12,0,0,0,0,0,0,13,13,13,5,8,9,6,8,0,0,0,0,0,0,7,9,10,9,13,4,8,8,1,0,11,12,13,4,9,9,6,0,6,5,0,0,0,0,0,0,0,5,4,0,4,3,3,11,12,0,8,2,5,12,11,7,6,3,9,13,13,13,13,13,9,2,0,0,0,0,0,0,0,2,8,8,1,0,1,7,6,8,9,9,0,11,10,6,5,0,3,2,0,2,1,0,0,0,0,0,0,0,11,1,10,6,12,13,7,0,9,8,1,7,1,9,8,2,13,11,13,7,2,0,0,0,0,0,0,9,3,10,11,13,7,9,3,8,4,7,4,10,10,9,5,7,5,8,10,8,0,0,0,0,0,0,9,11,9,12,9,8,6,7,13,6,8,13,7,9,11,9,8,7,8,0,0,0,0,0,0,0,0,0,0,0,0,10,8,7,9,13,9,0,13,13,13,13,10,9,5,0,0,0,0,0,0,0,0,0,13,13,13,13,0,5,9,0,2,1,2,9,0,10,9,5,8,10,9,0,0,0,0,0,0,6,11,8,7,13,13,1,8,0,9,10,0,8,9,11,9,4,13,4,0,0,0,0,13,13,13,0,0,0,0,0,0,13,12,11,12,11,12,11,0,12,0,8,9,2,0,0,0,0,0,0,7,2,7,1,2,7,8,9,1,2,0,9,13,5,8,9,6,8,7,0,0,0,0,0,0,9,10,9,13,4,8,8,1,0,9,6,8,10,12,0,0,0,0,0,0,13,11,13,0,6,8,9,5,0,9,13,10,11,12,13,13,13,5,8,9,6,8,7,9,10,9,13,4,0,0,0,0,0,0,8,8,1,0,11,12,13,4,9,9,6,0,6,5,0,5,4,0,4,3,3,11,0,0,0,0,0,0,12,0,8,2,5,12,11,7,6,3,9,13,13,13,0,0,0,0,0,0,13,13,9,2,0,2,8,8,1,0,1,7,6,8,9,9,0,11,10,0,0,0,0,0,0,6,5,0,3,2,0,2,1,0,11,1,10,6,12,13,7,0,9,8,0,0,0,0,0,0,1,7,1,9,8,2,13,11,13,7,2,9,3,10,11,13,7,9,3,8,4,7,4,10,0,0,0,0,0,0,10,9,5,7,5,8,10,8,9,11,9,12,9,8,6,7,13,6,8,13,7,9,0,0,0,0,0,0,11,9,8,7,8,10,8,7,9,13,9,0,13,13,13,0,0,0,0,0,0,13,10,9,5,0,0,0,0,0,0,0,0,0,13,13,13,0,0,0,0,0,0,13,0,5,9,0,2,1,2,9,0,10,9,5,8,10,9,6,11,8,7,13,13,1,8,0,0,0,0,0,0,0,9,10,0,8,9,11,9,4,13,4,0,0,0,0,13,13,13,13,12,11,0,0,0,0,0,0,12,11,12,11,0,12,0,8,9,2,7,2,7,1,2,7,8,9,1,2,0,9,13,5,8,9,6,8,7,0,0,0,0,0,0,9,10,9,13,4,8,8,1,0,9
14,13,19,7,14,14,0,0,0,0,0,0,14,9,0,10,7,8,9,6,14,14,14,0,0,0,0,0,0,8,10,12,13,11,13,0,6,8,14,0,0,0,0,0,19,14,14,9,5,0,9,13,10,11,12,13,14,0,0,0,0,0,0,13,14,13,5,8,9,6,8,7,14,9,0,0,0,0,0,0,10,9,13,4,8,14,8,1,0,11,12,13,4,19,14,14,14,0,0,0,0,0,0,9,6,0,6,5,0,5,4,0,4,3,14,14,14,14,14,3,11,12,0,0,0,0,0,0,0,8,2,5,12,11,14,7,6,3,19,13,13,14,13,13,13,9,2,0,2,8,8,14,0,0,0,0,0,0,1,0,1,7,6,8,9,14,9,0,11,10,6,5,0,3,2,0,2,1,0,14,11,1,10,6,12,13,7,0,9,14,0,0,0,0,19,0,8,1,7,1,9,8,2,13,11,13,7,2,9,3,14,10,11,13,7,9,3,8,14,4,7,4,10,10,0,0,0,0,0,0,9,5,14,7,5,8,10,8,9,11,9,12,9,8,14,6,7,13,6,8,13,7,9,11,0,19,0,0,0,0,9,8,14,7,8,10,8,7,9,13,9,0,13,13,0,0,0,0,0,0,14,0,0,0,0,0,0,13,13,10,9,5,0,0,0,14,0,0,0,14,0,0,0,14,5,9,0,2,14,2,19,0,0,0,0,0,0,0,0,0,0,0,0,0,10,9,5,8,10,9,6,11,8,7,14,14,1,8,0,9,10,0,8,9,11,9,4,13,4,0,0,0,0,13,13,0,0,0,0,0,0,14,13,12,11,14,11,12,11,0,14,0,8,9,2,7,12,7,19,0,0,0,0,0,0,2,7,8,9,11,2,0,9,13,5,8,9,6,8,7,9,10,9,13,14,8,8,1,0,0,0,0,0,0,0,9,14,14,14
14,0,0,0,0,0,0,14,14,0,0,0,0,0,0,14,8,10,12,0,0,0,0,0,0,13,11,13,0,6,8,14,14,0,0,0,0,0,0,13,9,7,14,14,0,0,0,0,0,0,14,9,0,9,5,0,9,13,10,11,12,13,0,0,0,0,0,0,14,13,14,13,5,8,9,6,8,7,14,9,10,9,13,4,8,14,0,0,0,0,0,0,8,1,0,11,12,13,4,9,14,14,14,9,6,0,6,5,0,5,0,0,0,0,0,0,4,0,4,3,14,14,8,2,5,12,11,14,7,6,3,9,13,13,14,0,0,0,0,0,0,14,14,3,11,12,0,14,13,10,6,5,0,3,2,0,0,0,0,0,0,0,2,1,2,8,13,13,9,2,0,9,0,11,8,14,1,0,1,7,6,8,9,0,0,0,0,0,0,14,0,14,11,1,10,6,12,13,7,0,9,14,8,1,7,1,0,0,0,0,0,0,9,8,2,13,11,13,7,2,9,3,14,10,11,13,7,9,3,8,14,0,0,0,0,0,0,7,4,8,4,10,10,9,5,14,7,5,8,10,8,9,11,9,12,9,8,0,0,0,0,0,0,14,6,7,13,9,0,13,13,14,13,13,10,9,5,0,0,0,0,0,0,0,6,8,13,7,9,11,9,8,14,7,8,10,8,7,9,13,14,0,0,0,0,0,0,0,0,14,0,0,0,0,14,5,9,0,0,0,14,2,14,2,9,0,10,0,0,0,0,0,0,9,5,8,10,9,6,11,8,7,14,14,1,8,0,9,10,0,8,9,0,0,0,0,0,0,11,9,4,13,4,0,0,0,0,13,14,13,9,7,14,14,14,9,0,10,7,8,9,6,0,0,0,0,0,0,14,14,14,8,10,12,13,11,13,0,6,8,14,14,14,9,5,0,0,0,0,0,0,0,9,13,10,11,12,13,14,13,14,13,5,8,9,6,8,7,14,9,0,0,0,0,0,0,10,9,13,5,4,0,4,3,14,14,14,14,14,3,11,12,0,8,2,5,12,11,14,7,6,3,9,4,8,14,8,1,0,0,0,0,0,0,0,11,12,13,4,9,14,14,14,9,6,0,6,5,0,13,13,14,13,0,0,0,0,0,0,13,13,9,2,0,2,8,8,14,1,0,1,7,6,8,9,14,9,0,11,10,6,5,0,0,0,0,0,0,0,3,2,0,2,1,0,14,11,1,10,6,12,13,7,0,9,14,8,1,7,1,9,8,2,13,0,0,0,0,0,0,7,9,3,8,14,4,7,4,10,10,9,5,14,7,5,8,10,8,9,11,9,12,9,8,14,6,7,13,6,8,13,7,0,0,0,0,0,0,9,11,9,8,14,7,8,10,8,7,9,13,9,0,13,13,14,13,13,10,9,5,0,0,0,8,7,14,14,1,8,0,9,10,0,0,0,0,0,0,0,8,9,11,9,4,13,4,0,0,0,0,13,13,14,13,12,11,14,11,12,11,0,14,0,8,9,2,0,0,0,0,0,0,7,12,7,1,2,7,8,9,11,2,0,9,13,5,8,14,0,0,0,14,0,0,0,0,0,0,0,0,0,14,5,9,0,2,14,2,9,0,10,9,5,8,10,9,6,11,0,9,6,8,0,0,0,0,0,0,7,9,10,9,13,14,8,8,1,0,9,14,14,14,10,7,8,9,6,14,14
0,0,0,0,0,0,15,2,1,11,9,0,5,4,15,0,0,0,0,0,0,15,3,4,4,4,2,0,0,0,0,0,0,0,15,9,10,11,1,3,5,10,10,3,12,4,0,0,0,0,0,0,13,2,6,11,13,7,13,14,12,6,0,0,0,0,0,0,15,3,1,7,10,8,1,11,10,3,13,10,9,14,13,11,8,9,13,15,3,0,9,3,0,7,0,0,0,0,0,0,1,10,8,0,11,12,6,0,7,13,0,6,13,10,2,13,10,12,2,1,0,0,0,0,0,0,14,2,5,4,7,9,14,9,8,5,6,11,10,3,4,12,4,1,1,14,14,10,11,15,3,15,13,0,5,7,12,0,0,0,0,0,0,5,8,5,11,8,9,11,1,15,1,3,4,14,1,0,10,15,5,0,14,6,9,7,7,11,8,6,15,10,5,8,0,2,1,3,15,3,6,14,8,0,0,0,0,0,0,0,0,15,3,14,3,11,4,3,13,12,1,12,1,4,13,0,5,9,6,14,15,14,6,5,8,12,4,13,0,4,15,15,8,5,14,6,13,7,7,6,13,6,1,11,3,4,15,0,0,0,0,0,0,15,10,15,14,6,2,5,7,1,11,4,12,0,7,13,13,6,1,14,13,3,7,3,15,15,5,3,0,0,0,0,0,0,15,14,2,3,15,7,4,5,6,14,12,12,15,14,0,9,1,13,2,11,15,14,11,3,0,5,7,10,1,14,6,9,5,9,9,2,15,13,3,11,12,4,13,14,2,0,11,14,9,0,0,0,0,0,0,0,15
15,0,0,0,0,0,0,10,8,8,2,7,12,14,0,0,0,0,0,0,15,0,0,0,0,0,0,15,0,0,0,0,0,0,15,10,5,10,12,3,2,2,0,1,0,0,0,0,0,0,15,12,1,10,14,8,8,13,9,12,12,11,0,0,0,0,0,0,15,15,15,4,2,15,10,7,5,15,0,0,0,0,0,0,15,8,8,1,6,7,8,1,15,1,11,1,15,2,2,0,8,15,8,7,5,10,15,15,15,8,12,1,3,5,6,0,0,0,0,0,0,6,3,12,15,14,0,15,0,9,3,14,3,0,15,5,10,6,15,13,0,3,4,3,7,1,15,2,7,3,8,13,5,13,13,0,0,0,0,0,0,13,14,10,12,15,11,4,10,0,3,12,3,13,15,11,12,15,15,0,0,0,0,0,0,15,7,6,13,0,5,3,14,6,14,1,4,15,6,11,8,6,0,0,0,0,0,0,7,15,2,4,0,10,5,6,1,3,15,3,1,14,1,15,5,9,10,14,15,2,3,9,0,0,0,0,0,0,11,13,3,2,15,15,15,10,10,12,15,0,9,9,12,8,10,4,9,15,15,15,0,0,0,0,0,0,11,8,7,10,8,11,13,6,11,15,10,12,5,4,14,9,12,0,0,0,0,0,0,1,4,15,14,8,9,14,7,0,9,15,15,15,3,3,13,3,8,11,4,9,10,14,4,2,0,0,0,0,0,0,10,9,7,7,15,9,11,14,2,0,1,12,11,10,1,15,5,5,10,3,15,5,6,0,12,11,10,0,0,0,0,0,0,15,15,15,4,11,1,0,7,6,5,9,15,4,13,10,0,11,7,4,7,7,11,15,0,8,14,9,6,11,0,0,0,0,0,0,15,6,0,6,13,8,2,8,15,15,15,15,12,8,0,1,2,10,13,14,8,15,9,0,9,2,14,15,15,0,0,0,0,0,0,15,9,14,4,13,12,10,10,2,8,15,9,3,10,6,9,4,9,15,11,3,4,15,12,9,0,0,0,0,0,0,0,15,15,0,0,0,0,0,0,15,15,0,0,0,0,0,0,15,15,15,7,6,9,2,0,6,2,15,10,15,0,0,0,0,0,0,0,3,11,3,15,12,4,12,12,9,11,15,4,3,8,15,1,10,12,6,14,8,13,0,0,0,0,0,0,14,15,15,15,4,10,10,0,6,11,15,13,5,11,4,10,15,0,7,5,12,6,15,11,7,2,13,15,13,15,9,12,15,12,4,7,13,0,0,0,0,0,0,8,15,2,15,0,15,8,4,5,0,9,15,3,12,8,3,14,1,11,15,0,15,9,0,0,0,0,0,0,13,12,15
0,0,0,0,0,0,15,15,0,0,0,15,8,4,12,3,6,2,0,12,2,4,0,0,0,0,0,0,15,0,7,6,13,5,7,12,1,9,0,0,0,6,1,8,1,4,14,3,3,13,1,5,1,11,13,11,12,0,0,0,0,0,14,15,14,15,0,0,0,0,0,0,15,11,12,11,12,0,0,0,0,13,14,15,13,12,12,14,14,12,12,0,0,0,0,0,0,0,0,12,11,13,11,10,1,9,7,3,13,13,2,2,12,1,0,0,0,0,0,0,10,10,3,12,11,0,1,0,1,0,1,0,1,13,1,7,12,12,11,0,0,0,0,0,0,0,0,0,0,0,0,3,6,8,14,15,9,1,12,0,1,0,2,0,3,0,4,0,0,0,12,15,9,0,0,0,0,0,0,2,1,11,7,12,15,9,7,8,10,5,11,2,8,7,13,5,7,10,15,5,8,12,0,0,0,0,0,0,3,12,3,4,4,3,10,3,11,7,13,4,4,2,0,10,0,1,0,1,0,1,0,0,0,1,0,1,13,15,11,9,9,8,9,10,7,2,2,11,13,0,0,0,0,0,0,10,6,4,8,0,8,6,8,15,10,14,6,12,11,0,6,1,5,1,6,13,7,2,4,13,10,11,0,0,0,0,0,0,15,6,0,0,0,5,9,3,2,14,0,0,0,1,1,12,4,9,3,15,5,10,0,0,0,0,0,0,2,6,0,6,8,13,0,10,13,0,1,0,1,2,1,0,4,0,5,1,2,10,1,8,1,15,13,8,8,5,11,0,10,0,0,0,0,0,0,1,11,14,1,9,12,3,9,10,6,1,15,14,8,1,0,13,0,0,0,0,0,0,13,8,12,10,9,2,2,0,0,0,0,0,0,12,8,1,11,1,11,0,11,5,12,12,0,0,0,0,0,0,0,8,9,3,6,3,14,12,4,5,8,4,1,1,0,4,5,10,15,9,12,5,9,3,13,0,0,0,0,0,0,6,14,2,9,4,6,6,7,4,10,7,12,14,1,5,7,0,0,0,1,0,4,2,0,0,0,0,0,0,0,0,0,0,0,0,14,1,3,9,3,10,0,8,4,3,14,15,0,1,0,15,13,8,6,9,14,10,0,0,0,0,0,0,8,13,3,0,6,4,4,15,0,0,1,0,14,4,6,15,13,11,11,0,0,0,0,0,0,14,13,15,15,15,11,13,15,11,13,13,13,15,15,0,0,0,0,0,0,15,11,12,13,12,15,13,9,3,5,12,2,8,12,10,14,15,10,10,13,3,0,0,0,0,0,0,11,6,2,7,15,4,5,6,11,2,0,14,11,1,12,12,15,14,0,0,0,0,0,0,13,0,4,6,15,9,13,11,0,12,1,4,4,12,7,0,6,3,2,5,8,0,0,0,0,0,0,0,7,0,0,15,6,15,6,5,13,10,5,11,14,4,2,12,11,0,2,5,12,3,8,9,7,14,6,0,0,0,0,0,0,10,1,0,3,0,1,12,7,6,4,13,5,10,15,2,4,11,3,4,14,3,1,11,4,3,7,0,0,0,0,0,0,0,0,10,9,4,15,15,7,13,6,7,15,10,8,9,7,15,7,7,10,11,9,7,12,7,12,6,0,0,0,0,0,0,15,0,0,0,0,0,0,15,9,8,10,12,9,15,15,13,8,15,13,15,11,3,3,1,11,0,0,0,0,0,0,7,8,6,14,0,15,4,9,15,15,7,2,3,10,10,8,12,0,0,0,0,0,0,14,7,14,5,11,4,11,1,8,16,10,7,13,13,0,0,0,0,0,0,15,15,10,12,5,14,13,14,15,3,13,14,8,0,0,0,0,0,0,14,10,15,10,10,4,14,11,10,14,6,0,0,0,0,0,0,11,8,0,15,4,15,8,15,12,15,4,14,8,14,12,12,15,0,12,0,1,0,9
20