
0,0,0,0,0,0,0,0,0,0,0,0,0,0,0,0,0,0,0,0,0,0,0,0,0
0,1,0,1,1,0,0,1,1,1,0,0,0,1,1,0,1,1,1,0,1,0,1,1,1,1,0,1,1,0,1,1,1,1,0,1,1,0,0,1,1,1
1,1,1,0,0,1,1,1,1,1,0,0,0,1,1,0,1,0,1,0,1,0,1,1,1,1,0,1,1,1,0,0,0,1,1,1,0,0,0,0,1,1,1,1,1,1,1,1,1,1
0,0,1,1,0,2,0,0,1,1,2,0,0,2,0,1,0,1,2,1,2,1,0,1,2,1,2,1,1,1,1,0,0,0,1,2,1,2,2,2
16,2,0,1,2,2,0,1,0,1,0,2,0,1,1,1,2,0,1,2,0,2,2,2,2,16,0,0,2,2,2,1,2,2,1,2,0,2,1,0,1,2,2,2,1,2,0,2,0,1,16,2,1,0,0,1,2,1,2,2,2,1
3,0,3,2,2,1,1,2,1,2,3,0,0,0,1,2,2,2,1,1,3,2,1,1,2,1,2,2,1,2,3,0,2,0,0,0,0,0,3,2,1,1,2,0,2,1,0,0,2,2,2,3,1,0,2,3,1,1,0,0,2,1,2,1,0,2,1,0,2,1,3
0,1,2,3,4,0,4,0,1,0,2,4,0,2,4,3,0,4,1,2,4,2,3,1,2,4,4,4,4,4,1,2,1,3,1,2,0,4,0,4,4,4,0,1,4,2,4,0,4,4,4
4,3,0,1,4,2,4,2,4,1,4,4,2,4,0,1,4,0,3,4,0,4,3,4,1,2,4,3,4,3,0,1,3,2,4,3,4,3,2,0,3,4,0,1,0,2,0,3,0,1,1,1,2,4,1,4,2,1,3,1,4,2,1
5,0,1,2,3,4,0,5,5,4,0,1,0,2,4,0,2,4,3,5,5,0,5,4,1,5,2,4,2,3,1,5,2,4,5,5,5,5,4,5,4,4,1,2,1,0,1,2,0,4,3,4,5,2,0,1,5,2,4,0,4,5,5
17,3,0,2,0,4,5,4,5,2,1,0,5,0,2,1,2,0,4,1,5,4,3,2,5,17,1,5,0,4,0,5,2,1,4,3,3,1,0,4,3,5,5,1,0,17,3,2,3,1,0,0,5,0,1,0,4,1,1,1,5,2,4,1,17,2,4,1,2,5,2,5,5,4,3,2,1,0,5,4,1,5,2,5,3,17
6,0,1,0,6,6,5,6,5,0,4,6,3,2,1,0,1,2,1,3,1,4,6,1,5,1,6,1,2,3,6,0,6,4,5,3,2,1,0,6,0,4,3,2,1,2,3,4,3,2,1,6,6,6,0
6,6,5,6,5,6,5,6,4,6,5,6,6,6,3,6,2,6,6,6,6,5,4,2,3,6,6,5,6,4,5,4,6,4,3,4,5,4,4,4,6,5,6,5,6,5,6,6,5,5,4,6,6,6,6,6,5,5,6,6,6,6,6,6,5,5,5,5,5,4,4,4,4,3,3,3,2,2,6,6,4,5,4,6,5,6,3,6,2,4,5,2,4,2,6,6
6,5,6,5,6,4,6,5,6,4,6,4,6,6,3,6,3,5,3,4,3,6,3,5,3,6,3,5,3,4,3,2,3,2,3,2,3,6,3,6,3,6,5,4,5,6,4,3,5,6,2,5,4,3,6,6,5,2,3,5,6,5,4,3,6,5,6,4,5,3,6,5,4,5,6,6,6,6,6,6,6,6,5,4,5,5,6,5,6,3,2,5,3,4,5,5,6,4,6
7,2,7,6,6,3,5,7,6,5,6,7,5,6,4,6,5,6,3,2,3,2,6,7,7,6,3,6,2,6,7,7,7,2,5,4,6,7,6,2,2,3,5,4,6,7,7,6,5,4,7,2,7,6,6,5,7,6,4,5,7,4,6,7,7,4,3,4,5,4,7,7,4,4,6,5,6,5,3,5,7,5,6,6,7,5,5,4,6,7,6,6,7,7,7,7,7,6,6,6,6,7,5,5,5,5,7,4,4,4,7,3,3,2,2,7
7,7,8,6,8,6,8,5,5,8,6,8,7,4,8,8,18,4,3,8,2,5,7,6,3,2,2,8,8,7,6,8,7,8,18,7,8,2,7,2,3,7,3,8,4,7,4,5,7,18,5,8,8,8,6,7,6,8,7,8,7,8,8,7,8,18,8,8,8,2,7,2,7,2,7,8,8,8
8,8,6,8,8,7,7,8,8,6,6,8,5,5,8,4,8,8,6,8,3,8,4,8,8,5,8,7,6,8,4,7,4,3,8,5,8,4,8,7,6,2,8,8,7,4,8,6,5,3,8,8,7,5,8,6,5,4,8,2,8,5,6,3,2,4,8,2,8,2,5,4,8,7,8,2,8,8,7,4,5,2,4,8,8,5,8,8,8,8,8,6,8,4,2,5
9,7,9,7,8,9,6,8,6,8,9,5,9,5,8,9,4,6,8,7,9,9,4,8,4,8,1,4,9,9,3,8,2,5,7,6,3,9,9,2,2,8,8,7,6,8,9,9,7,9,8,7,9,8,2,7,2,9,3,7,9,3,8,4,7,4,9,5,7,5,8,8,9,9,9,8,6,7,6,8,7,9,9,8,7,8,8,7,9,9,8,9,8,9,1,9,8,1,8,8,9,9,9
9,7,9,4,7,8,9,6,8,6,8,9,5,9,5,8,9,6,8,7,9,9,4,8,8,1,4,9,9,3,8,2,5,7,6,3,9,4,9,2,2,8,8,1,1,7,6,8,9,9,7,9,8,1,7,1,9,8,2,7,2,9,3,7,9,3,8,4,7,9,7,9,7,8,9,6,8,6,8,9,5,9,5,8,9,6,8,7,9,9,4,8,8,1,4,9,9,3,8,2,5,7,6,3,9,9,2,2,8,1,8
7,9,7,9,8,9,7,9,7,8,9,6,8,6,8,9,5,9,5,8,9,6,8,7,9,9,4,8,8,4,9,9,3,8,2,5,4,7,6,3,9,9,2,2,8,8,7,6,8,9,9,7,9,8,7,9,8,2,7,2,9,3,7,9,3,8,4,7,4,9,5,7,5,8,8,9,9,9,8,6,7,6,8,7,9,9,8,7,8,8,7,9,6,8,6,8,9,5,5,8,6,8,7,9,9,4,8,8,1,4,9,9,3,8,2,5,9,7
10,9,7,4,6,19,3,9,7,8,9,6,1,8,6,19,10,9,5,19,9,1,5,8,9,6,8,7,9,1,9,4,8,8,1,19,4,1,1,9,9,3,1,1,8,2,5,7,19,1,6,3,9,19,1,9,1,2,2,8,1,10,19,1,7,6,1,8,9,9,7,1,19,9,8,1,7,10,19,1,9,8,1,1,3,7,9,3,8,19,4,7,9,7,9,1,7,10,9,1,6,8,19,6,8,1,9,5,1,9,5,8,1,9,6,8,7,9,1,9,19,1,1,19
10,9,7,9,10,7,10,8,9,6,1,9,7,9,7,8,9,6,1,8,10,6,10,8,9,5,1,9,1,5,8,9,6,8,7,9,9,4,8,8,1,10,4,1,10,9,9,3,10,10,8,10,2,5,7,1,10,6,3,9,9,10,2,2,8,1,8,1,1,7,6,10,8,9,9,10,10,6,3,9,1,10,9,10,2,2,8,10,8,1,1,7,6,10,8,9,9,7,1,1,9,8,10,7,1,1,9,8,10,2,7,2,10,9,1,3,7,9,3,8,10,4,7,9,7,9,1,7,8,9
4,11,1,9,7,4,11,5,11,7,11,2,9,7,1,11,1,2,11,6,5,6,6,6,3,6,2,6,1,2,3,11,4,5,1,1,8,9,6,1,8,11,1,11,1,6,1,8,9,5,1,9,1,11,11,4,3,4,1,2,4,3,3,11,1,2,7,1,3,4,11,5,8,9,6,8,7,9,1,9,11,1,11,4,11,5,11,6,11,11,11,11,11,4,8,8,1,1,4,5,11,6,11,1,1,9,9,7,6,5,7,8,9,1,11,8,2,5,7,6,3,9,1,1,9,1,2,1,2,3,11,11,11,2,5,8,11,4,2,7,2,11,11
11,4,11,9,7,11,10,8,6,11,6,8,11,4,11,5,11,7,11,2,9,7,10,1,11,2,4,3,5,5,1,2,11,2,3,11,4,5,8,9,6,1,10,11,8,1,1,7,6,8,9,11,1,11,1,6,1,8,9,5,1,9,1,11,10,2,1,4,11,3,11,1,4,2,3,1,2,11,7,1,3,4,11,5,8,9,6,8,7,9,1,9,11,10,11,4,11,5,11,6,11,11,11,11,11,4,8,8,1,1,4,5,11,6,11,1,10,9,9,5,6,7,8,9,1,11,1,8,2,5
12,1,4,11,12,1,9,7,4,11,12,5,11,12,7,11,12,2,9,7,1,11,12,2,11,2,3,12,11,4,12,5,12,1,8,9,6,1,12,8,11,11,12,6,1,8,9,5,1,12,9,1,11,12,11,1,2,12,7,1,3,4,11,5,8,9,6,12,8,7,9,12,12,12,1,9,11,1,11,4,11,5,11,12,11,11,1,11,12,4,8,8,12,1,4,5,11,6,11,1,1,9,9,3,1,12,12,12,1,1,2,3,4,5,6,7,8,9,11,4
13,9,7,9,17,7,8,9,6,8,17,12,13,11,7,13,6,8,9,19,9,13,17,1,17,12,13,13,13,5,8,9,16,8,7,9,17,9,13,18,8,8,17,11,7,12,13,4,9,9,6,6,16,5,7,7,6,3,9,13,13,13,13,13,9,2,2,8,8,1,7,17,7,6,8,9,9,11,7,17,6,19,3,2,2,17,11,7,17,1,7,6,12,13,7,9,8,17,7,1,7,9,8,2,13,11,7,13,7,2,9,3,17,11,7,13,7,9,3,8,18,7,13,5,8,9,6,8,7,9,1,7,19,13,18
13,13,9,7,9,1,7,8,9,13,9,7,9,1,7,8,9,6,8,12,13,11,13,6,8,9,5,9,13,1,11,12,13,13,13,5,8,9,6,8,7,9,1,9,13,4,8,8,11,12,13,4,9,9,6,6,5,5,4,4,3,3,11,12,8,2,5,12,11,7,6,3,9,13,13,13,13,13,9,2,2,8,8,1,1,7,6,8,9,9,11,1,6,5,3,2,2,1,11,6,12,13,7,9,8,1,7,1,9,8,2,13,11,13,7,2,9,3,1,11,13,7,9,3,8,4,7,4,9,5,7,5,8,1,8,9,11,9,12,9,8,6,7,13,6,8,13,7,9,11,9,8,7,8,8,7,9,13,9,13,13,13,13
14,13,11,7,14,14,14,9,1,7,8,9,6,14,14,14,8,12,13,11,13,6,8,14,11,14,14,9,5,9,13,1,11,12,13,14,13,14,13,5,8,9,6,8,7,14,9,1,9,13,4,8,14,8,1,11,12,13,4,11,14,14,14,9,14,14,14,14,14,3,11,12,8,2,5,12,11,14,7,6,3,11,13,13,14,13,13,13,9,2,2,8,8,14,1,1,7,6,8,9,14,9,11,1,6,5,3,2,2,1,14,11,1,6,12,13,7,9,14,11,8,1,7,1,9,8,2,13,11,13,7,2,9,3,14,11,13,7,9,3,8,14,4,7,4,1,1,9,5,14,7,5,8,1,8,9,11
15,2,1,11,9,5,4,15,15,3,4,4,4,2,15,9,1,11,1,3,5,3,12,4,13,2,6,11,13,7,13,14,12,6,15,3,1,7,1,8,1,11,1,3,13,1,9,14,13,11,8,9,13,15,3,9,3,7,8,11,12,6,7,13,6,13,1,2,13,1,12,2,1,14,2,5,4,7,9,14,9,8,5,6,11,1,3,4,12,4,1,1,14,14,1,11,15,3,15,13,5,7,12,5,8,5,11,8,9,11,1,15,1,3,4,14,1,1,15,5,14,6,9,7,7,11,8,6,15,1,5,8,2,1,3,15,3,6,14,8,15,3,14,3,11,4,3,13,12,1,12,1,4,13,5,9,6,14,15,14,6,5,8,12,13,13,6,1,14
15,1,8,8,2,7,12,14,15,15,15,5,12,3,2,2,1,15,12,14,8,8,13,9,12,12,11,15,15,15,4,2,15,1,7,5,15,15,8,8,6,7,8,1,15,1,11,1,15,2,2,8,15,8,7,5,1,15,15,15,8,12,1,3,5,6,6,3,12,15,14,15,9,3,14,3,15,5,1,6,15,13,3,4,3,7,1,15,2,7,3,8,13,5,13,13,13,14,1,12,15,11,4,1,3,12,3,13,15,11,12,15,15,15,7,6,13,5,3,14,6,14,1,4,15,6,11,8,6,7,15,15,3,1,14,1,15,5,9,1,15,1,12,11,1,1,15,5,5,1,4,13,12
20